Multi Tasking Staff === Multitasking Staff VIPwQsKv
Leather, Lifestyle and Product DesignÂ„ === Leather, Lifestyle and Product Design_x0084_ h4i4xwcE
key_id: h4i4xwcE, value_id: t69gL6Ynl does't exist
Post Doctoral Certificate Course === PostdoctoralCertificate Course nWIiWAv7
Post Doctoral Fellowship === PostdoctoralFellowship nWIiWAv7
Multi Tasking Staff === Multitasking Staff iJg6EsMk
3D Modeler === 3D Modeller q9LzwSSI
Aaya === Aayah q9LzwSSI
Academic Associates === Academic Associate q9LzwSSI
Academic Consultants === Academic Consultant q9LzwSSI
Academic cum Teaching Associate === Academic-cum-Teaching Associate q9LzwSSI
Acadmic-cum-Teaching Associate === Academic-cum-Teaching Associate q9LzwSSI
Account cum Cashier === Account-cum-Cashier q9LzwSSI
Accountants === Accountant q9LzwSSI
Accountant (female) === Accountant (Female) q9LzwSSI
Accountant Gr-I === Accountant Grade-I q9LzwSSI
Accountant cum Administrative officer === Accountant-cum-Administrative officer q9LzwSSI
Accountant - cum- Admn. Officer === Accountant-cum-Administrative Officer q9LzwSSI
Accountant cum Cashier === Accountant-cum-Cashier q9LzwSSI
Accountant cum Clerk === Accountant-cum-Clerk q9LzwSSI
Accountant cum Data Entry Operator === Accountant-cum-Data Entry Operator q9LzwSSI
Accountant cum Establishment Clerk === Accountant-cum-Establishment Clerk q9LzwSSI
Accountant cum Executive Officer === Accountant-cum-Executive Officer q9LzwSSI
Accountant cum Programme Coordinator === Accountant-cum-Programme Coordinator q9LzwSSI
Accountant Cum Store Manager === Accountant-cum-Store Manager q9LzwSSI
Accountant cum Training Manager === Accountant-cum-Training Manager q9LzwSSI
Account and Audit Assistant === Accounts and Audit Assistant q9LzwSSI
Account Assistant === Accounts Assistant q9LzwSSI
Accounts Asst.Gr.III === Accounts Assistant Grade-III q9LzwSSI
Account Assistant cum Cashier === Accounts Assistant-cum-Cashier q9LzwSSI
Accounts Assistant Cum Cashier === Accounts Assistant-cum-Cashier q9LzwSSI
Accounts Assistant cum Data Entry Operator === Accounts Assistant-cum-Data Entry Operator q9LzwSSI
Account Auditor === Accounts Auditor q9LzwSSI
Account Clerk === Accounts Clerk q9LzwSSI
Accounts Clerk cum Typist === Accounts Clerk-cum-Typist q9LzwSSI
Account Executive === Accounts Executive q9LzwSSI
Accounts Executives === Accounts Executive q9LzwSSI
Account Manager === Accounts Manager q9LzwSSI
Account Manager Cum Data Analyst === Accounts Manager-cum-Data Analyst q9LzwSSI
Accounts  Officer === Accounts Officer q9LzwSSI
Account Officer === Accounts Officer q9LzwSSI
Account Officers === Accounts Officers q9LzwSSI
Accounts Officer (A - V) === Accounts Officer (A-V) q9LzwSSI
Account Opening Staff === Accounts Opening Staff q9LzwSSI
Account Supervisor === Accounts Supervisor q9LzwSSI
Accounts-Cum-Administrative Officer === Accounts-cum-Administrative Officer q9LzwSSI
Acctt.cum Estt.Clerk === Acctt.-cum-Estt. Clerk q9LzwSSI
Act Apprenice === Act Apprentice q9LzwSSI
Act Apprentices === Act Apprentice q9LzwSSI
Ad-hoc Attendants Supervisor === Ad-hoc Attendant Supervisor q9LzwSSI
Additional District And Sessoins Judge === Additional District And Sessions Judge q9LzwSSI
Additional District Judges === Additional District Judge q9LzwSSI
Admin & Account Assistant === Admin & Accounts Assistant q9LzwSSI
Admin cum Accounts Executive Assistant === Admin-cum-Accounts Executive Assistant q9LzwSSI
Admin cum Finance === Admin-cum-Finance q9LzwSSI
Admin cum Finance Assistant === Admin-cum-Finance Assistant q9LzwSSI
Administration and Account Officer === Administration and Accounts Officer q9LzwSSI
Administration/Account Officer === Administration/Accounts Officer q9LzwSSI
Admn. Asst. Gr.III === Administrative Assistant Grade-III q9LzwSSI
Administrative Assistant cum Computer Operator-Block === Administrative Assistant-cum-Computer Operator-Block q9LzwSSI
Administrative Assistant cum Computer Operator-District === Administrative Assistant-cum-Computer Operator-District q9LzwSSI
Administrative Assistant cum Coordinator === Administrative Assistant-cum-Coordinator q9LzwSSI
Administrative Assistant cum Data Manager === Administrative Assistant-cum-Data Manager q9LzwSSI
Administrative Members === Administrative Member q9LzwSSI
Administrative Officers === Administrative Officer q9LzwSSI
Administrative Officer Cum Accounts Officer === Administrative Officer-cum-Accounts Officer q9LzwSSI
Administrative Suprintendent === Administrative Superintendent q9LzwSSI
Administrative cum Accounts === Administrative-cum-Accounts q9LzwSSI
Administrative cum Accounts Assistant === Administrative-cum-Accounts Assistant q9LzwSSI
Administrative-cum-Account Officer === Administrative-cum-Accounts Officer q9LzwSSI
Administrative cum Account Officer === Administrative-cum-Accounts Officer q9LzwSSI
Administrative Cum Accounts Officer === Administrative-cum-Accounts Officer q9LzwSSI
Admn.-cum-Accounts Officer === Administrative-cum-Accounts Officer q9LzwSSI
Admn-cum-Accounts Officer === Administrative-cum-Accounts Officer q9LzwSSI
Administrative-cum-Accounts Officer - Regular === Administrative-cum-Accounts Officer-Regular q9LzwSSI
Administrative cum Finance and Accounts Officer === Administrative-cum-Finance and Accounts Officer q9LzwSSI
Administrative cum Finance Officer === Administrative-cum-Finance Officer q9LzwSSI
Administrative-Cum-liaison Officer === Administrative-cum-Liaison Officer q9LzwSSI
Admn. Consultant === Administrativie Consultant q9LzwSSI
Adviosr === Advisor q9LzwSSI
Advisors === Advisor q9LzwSSI
Advisors of the Centres === Advisor of the Centres q9LzwSSI
Advisors Professional === Advisor Professional q9LzwSSI
Advisor cum Consultant === Advisor-cum-Consultant q9LzwSSI
Advocates === Advocate q9LzwSSI
AgniveerVayu === Agniveer Vayu q9LzwSSI
Agri Markting Specialist === Agri Marketing Specialist q9LzwSSI
Agri-Business Experts === Agri-Business Expert q9LzwSSI
Agricultural Assistant Grade II === Agricultural Assistant Grade-II q9LzwSSI
Agriculture domain expert === Agriculture Domain Expert q9LzwSSI
Agriculture Fieldman === Agriculture Fieldsman q9LzwSSI
Agrovet Service Representatives === Agrovet Service Representative q9LzwSSI
Air Conditioner cum Refrigeration Mechanic === Air Conditioner-cum-Refrigeration Mechanic q9LzwSSI
Air Worthiness Officer === Airworthiness Officer q9LzwSSI
Aaesthetist === Anaesthetist q9LzwSSI
Anchor cum Correspondent Grade- I === Anchor-cum-Correspondent Grade-I q9LzwSSI
Anchor cum Correspondent Grade-III === Anchor-cum-Correspondent Grade-III q9LzwSSI
Aneasthesia Technician === Anesthesia Technician q9LzwSSI
Antenatal Medical Officer cum Assistant Professor === Antenatal Medical Officer-cum-Assistant Professor q9LzwSSI
Antenatal Medical Officer Cum Lecturer === Antenatal Medical Officer-cum-Lecturer q9LzwSSI
Antenatal Medical Cum Lecturer === Antenatal Medical-cum-Lecturer q9LzwSSI
Application Analysts === Application Analyst q9LzwSSI
Appraisers === Appraiser q9LzwSSI
Apprentices === Apprentice q9LzwSSI
Apprentices Trainees === Apprentice Trainee q9LzwSSI
Apprentice Trainees === Apprentice Trainee q9LzwSSI
Apprenticeship === Apprenticehip q9LzwSSI
Apprentiiceship === Apprenticeship q9LzwSSI
Apprenticeship and Placement Officer === Apprenticehip and Placement Officer q9LzwSSI
Apprenticeship Instructor === Apprenticehip Instructor q9LzwSSI
Apprenticeship Supervisor === Apprenticehip Supervisor q9LzwSSI
Apprenticeship Trainee === Apprenticehip Trainee q9LzwSSI
Apprenticeship Training === Apprenticehip Training q9LzwSSI
Architects === Architect q9LzwSSI
Architectural Draftsman Grade I === Architectural Draftsman Grade-I q9LzwSSI
Architectural Draftsman Grade II === Architectural Draftsman Grade-II q9LzwSSI
Armed Guards === Armed Guard q9LzwSSI
Arms and Amours === Arms and Armours q9LzwSSI
Art cum Craft Teacher === Art-cum-Craft Teacher q9LzwSSI
Artisan Trainees === Artisan Trainee q9LzwSSI
Artists === Artist q9LzwSSI
Astist-A === Artist-A q9LzwSSI
Artist Cum Modeller === Artist-cum-Modeller q9LzwSSI
Artist cum Photographer === Artist-cum-Photographer q9LzwSSI
Asset cum Vendor Coordinator === Asset-cum-Vendor Coordinator q9LzwSSI
Assistant Senior === Assistant  q9LzwSSI
Asistant === Assistant q9LzwSSI
Assistants === Assistant q9LzwSSI
Assistant (A-lI) === Assistant (A-II) q9LzwSSI
Assistant (A-ll) === Assistant (A-II) q9LzwSSI
Assistant (A-Ill) === Assistant (A-III) q9LzwSSI
Assistant (A-lll) === Assistant (A-III) q9LzwSSI
Asstt. Acctts Officer === Assistant Accounts Officer q9LzwSSI
Asst Acctts Officer === Assistant Accounts Officer q9LzwSSI
Assistant Account Officer === Assistant Accounts Officer q9LzwSSI
Assistant Account Trainee === Assistant Accounts Trainee q9LzwSSI
Assisstant Administrative officer === Assistant Administrative officer q9LzwSSI
Assistant Aircraft Radio Mechanic (Assistant Sub- Inspector) === Assistant Aircraft Radio Mechanic (Assistant Sub-Inspector) q9LzwSSI
Assistant Apprenticeship Advisor === Assistant Apprenticehip Advisor q9LzwSSI
Assistant bio-chemist === Assistant Biochemist q9LzwSSI
Assistant caretaker === Assistant Caretaker q9LzwSSI
Assistant Central Intelligence Officer -I === Assistant Central Intelligence Officer-I q9LzwSSI
Assistnat Chie Finance Officer === Assistant Chief Finance Officer q9LzwSSI
Assistant Commandants === Assistant Commandant q9LzwSSI
Assistant Comissioner === Assistant Commissioner q9LzwSSI
Asst Commissioner === Assistant Commissioner q9LzwSSI
Assistant Commissioner -I === Assistant Commissioner-I q9LzwSSI
Assistant Commissioner -II === Assistant Commissioner-II q9LzwSSI
Assistant Controlle === Assistant Controller q9LzwSSI
Asstt. Controller === Assistant Controller q9LzwSSI
Assistant Controller Legal Measurement (Grade-I) === Assistant Controller Legal Measurement Grade-I q9LzwSSI
Assistant Controller Legal Measurement (Grade-II) === Assistant Controller Legal Measurement Grade-II q9LzwSSI
Assistant  Cook-cum-Caretaker === Assistant Cook-cum-Caretaker q9LzwSSI
Assistant Data Base Administrator === Assistant Database Administrator q9LzwSSI
Assistant  Director === Assistant Director q9LzwSSI
Assistnat Director === Assistant Director q9LzwSSI
Assistant Director-ll [Admin] === Assistant Director-ll (Admin) q9LzwSSI
Assistant Edior === Assistant Editor q9LzwSSI
Assistant Employment Officers === Assistant Employment Officer q9LzwSSI
Assistant Enginee === Assistant Engineer q9LzwSSI
Assistant Engineeer === Assistant Engineer q9LzwSSI
Asstt.Engineer === Assistant Engineer q9LzwSSI
Assistant Executive  Engineer === Assistant Executive Engineer q9LzwSSI
Assistant  General Manager === Assistant General Manager q9LzwSSI
Assistant General Manage === Assistant General Manager q9LzwSSI
Asst. General Manager === Assistant General Manager q9LzwSSI
Assistant Grade-3 Cum Computer Operator === Assistant Grade-3-cum-Computer Operator q9LzwSSI
Assistant Grade I === Assistant Grade-I q9LzwSSI
Assistant Grade II === Assistant Grade-II q9LzwSSI
Assistant Grade III === Assistant Grade-III q9LzwSSI
Assistant Grade III (Lower Division Clerk) === Assistant Grade-III (Lower Division Clerk) q9LzwSSI
Assistant Hostel Wardens === Assistant Hostel Warden q9LzwSSI
Assistant Jailor Grade I === Assistant Jailor Grade-I q9LzwSSI
Assistant Labour Officer Grade II === Assistant Labour Officer Grade-II q9LzwSSI
Asst. Labour Welfare Officer === Assistant Labour Welfare Officer q9LzwSSI
Assistant Landscapping Officer === Assistant Landscaping Officer q9LzwSSI
Assistant Laundary Supervisor === Assistant Laundry Supervisor q9LzwSSI
Assistant Law Officers === Assistant Law Officer q9LzwSSI
Assistant Lecturer cum Assistant Instructor === Assistant Lecturer-cum-Assistant Instructor q9LzwSSI
Assistant Liberian === Assistant Librarian q9LzwSSI
Asstt. Library & Information Office === Assistant Library & Information Office q9LzwSSI
Assistant  Library & Information Officer === Assistant Library & Information Officer q9LzwSSI
Assistant Machinists === Assistant Machinist q9LzwSSI
Asistant Manager === Assistant Manager q9LzwSSI
Asstt. Manager === Assistant Manager q9LzwSSI
Assistant Managers === Assistant Manager q9LzwSSI
Asst. Manager === Assistant Manager q9LzwSSI
Assistant Manage === Assistant Manager q9LzwSSI
Assistant Manager- cum-Store Keeper === Assistant Manager-cum-Store Keeper q9LzwSSI
Assistant Manager Cum Store Keeper === Assistant Manager-cum-Store Keeper q9LzwSSI
Assistant Manager Cum Storekeeper === Assistant Manager-cum-Storekeeper q9LzwSSI
Assistant Manager-Cum-Storekeeper === Assistant Manager-cum-Storekeeper q9LzwSSI
Assistant Manager/ Sr. Executive/ Executive === Assistant Manager/  Executive/ Executive q9LzwSSI
Assistant Manager/Senior Executive/Executive === Assistant Manager/ Executive/Executive q9LzwSSI
Asst Master (TGT) === Assistant Master (TGT) q9LzwSSI
Assistant Mine Surveyor/ Mine Surveyor === Assistant Mine Surveyor/Mine Surveyor q9LzwSSI
Assistant Nursing Superintend === Assistant Nursing Superintendent q9LzwSSI
Assistant Nursingh Superintendent === Assistant Nursing Superintendent q9LzwSSI
Asstt Officer === Assistant Officer q9LzwSSI
Asst. Officer (P&A)/ Asst. Officer (F&A) === Assistant Officer (P&A)/ Assistant Officer (F&A) q9LzwSSI
Assistant Officer -in- Charge === Assistant Officer-in-Charge q9LzwSSI
ASSISTANT PHYSICAL EDUCATION OFFICER === Assistant Physical Education Officer q9LzwSSI
Assistant Profeoosr === Assistant Professor q9LzwSSI
Assistant Profeesor === Assistant Professor q9LzwSSI
Assiatant Professor === Assistant Professor q9LzwSSI
Assistant Porfessor === Assistant Professor q9LzwSSI
Assistant  Professor === Assistant Professor q9LzwSSI
Assistant Professr === Assistant Professor q9LzwSSI
Assistant Professors === Assistant Professor q9LzwSSI
Asst. Professor === Assistant Professor q9LzwSSI
Asistant Professor === Assistant Professor q9LzwSSI
Assistant Professor Grade - I === Assistant Professor Grade-I q9LzwSSI
Assistant Professor (Grade-I) === Assistant Professor Grade-I q9LzwSSI
Assistant Professor(Grade-I) === Assistant Professor Grade-I q9LzwSSI
Assistant Professor (Grade I) === Assistant Professor Grade-I q9LzwSSI
Assistant Professor Grade -I === Assistant Professor Grade-I q9LzwSSI
Assistant Professor Grade I === Assistant Professor Grade-I q9LzwSSI
Assistant Professor Grade -II === Assistant Professor Grade-II q9LzwSSI
Assistant Professor Grade - II === Assistant Professor Grade-II q9LzwSSI
Assistant Professor (Grade II) === Assistant Professor Grade-II q9LzwSSI
Assistant Professor Grade_II === Assistant Professor Grade-II q9LzwSSI
Assistant Professor Grade II === Assistant Professor Grade-II q9LzwSSI
Assistant Professor (Grade-II) === Assistant Professor Grade-II q9LzwSSI
Assistant Professor Grade- II === Assistant Professor Grade-II q9LzwSSI
Assistant professor Gr-l === Assistant professor Grade-l q9LzwSSI
Assistant professor Gr-ll === Assistant professor Grade-ll q9LzwSSI
Assistant Professor cum Coordinator === Assistant Professor-cum-Coordinator q9LzwSSI
Assistant Professor Cum Junior Scientist === Assistant Professor-cum-Junior Scientist q9LzwSSI
Assistant Professor Cum Medical Speciailist === Assistant Professor-cum-Medical Specialist q9LzwSSI
Assistant Professor cum Placement Officer === Assistant Professor-cum-Placement Officer q9LzwSSI
Assistant Professor cum Statistician === Assistant Professor-cum-Statistician q9LzwSSI
Assistant Professor/Sr. Tutor === Assistant Professor/ Tutor q9LzwSSI
Asstistant Project Officer === Assistant Project Officer q9LzwSSI
Assistant Prosthetics cum Orthotics === Assistant Prosthetics-cum-Orthotics q9LzwSSI
Assistant Registar === Assistant Registrar q9LzwSSI
Asst. Scientific Officer (Entomology) === Assistant Scientific Officer (Entomology) q9LzwSSI
Assistant Section Officers === Assistant Section Officer q9LzwSSI
Assistant Security Officer cum Transport Manger === Assistant Security Officer-cum-Transport Manager q9LzwSSI
Assistant Security Officer Cum Transport Manager === Assistant Security Officer-cum-Transport Manager q9LzwSSI
Assistant Skill Coodinator === Assistant Skill Coordinator q9LzwSSI
Assistant Sub- Inspector === Assistant Sub-Inspector q9LzwSSI
Asst Superintendant === Assistant Superintendent q9LzwSSI
Assitant System Manager === Assistant System Manager q9LzwSSI
Assistant Teachers === Assistant Teacher q9LzwSSI
Asstt.Tech.Manager === Assistant Tech. Manager q9LzwSSI
Assistant Technical Manage === Assistant Technical Manager q9LzwSSI
Asst. Technical Officer === Assistant Technical Officer q9LzwSSI
Assistant Tester cum Gauger === Assistant Tester-cum-Gauger q9LzwSSI
Assistant To Senior Programmer === Assistant To  Programmer q9LzwSSI
Assistant cum Bench Clerk === Assistant-cum-Bench Clerk q9LzwSSI
Assistant cum Caretaker === Assistant-cum-Caretaker q9LzwSSI
Assistant cum Computer Operato === Assistant-cum-Computer Operator q9LzwSSI
Assistant cum Data Entry Operator === Assistant-cum-Data Entry Operator q9LzwSSI
Assistant/Office Superintendent-Cum-Accountant === Assistant/Office Superintendent-cum-Accountant q9LzwSSI
Assistantship === Assistanthip q9LzwSSI
Associates === Associate q9LzwSSI
Accociate Professor === Associate Professor q9LzwSSI
Assosiate Professor === Associate Professor q9LzwSSI
Associate Professors === Associate Professor q9LzwSSI
Associate Professor-cum-Senior Scientist === Associate Professor-cum- Scientist q9LzwSSI
Associate Sr. Design Instructor === Associate Senior Design Instructor q9LzwSSI
Associate Sr. Technical Instructor === Associate Senior Technical Instructor q9LzwSSI
Attendent === Attendant q9LzwSSI
Attendant Gr.I === Attendant Grade-I q9LzwSSI
Attendant-Cum-Cleaner === Attendant-cum-Cleaner q9LzwSSI
Attendant-Cum-Server === Attendant-cum-Server q9LzwSSI
Attendant cum Technician === Attendant-cum-Technician q9LzwSSI
Attendant cum Technician Trainee === Attendant-cum-Technician Trainee q9LzwSSI
Attenders === Attender q9LzwSSI
Attender Grade II === Attender Grade-II q9LzwSSI
Audiologist cum Speed Therapist === Audiologist-cum-Speech Therapist q9LzwSSI
Audiologist cum Speech Therapist === Audiologist-cum-Speech Therapist q9LzwSSI
Audit cum Finance Officer === Audit-cum-Finance Officer q9LzwSSI
Auditorium Supervisor cum Manager === Auditorium Supervisor-cum-Manager q9LzwSSI
Authorized Medical Officer cum Resident Medical Consultant === Authorized Medical Officer-cum-Resident Medical Consultant q9LzwSSI
Auxiliary Nurse Cum Midwife === Auxiliary Nurse-cum-Midwife q9LzwSSI
Auxilary Nuring Midwife === Auxiliary Nursing Midwife q9LzwSSI
Auxiliary-Nursing-Cum-Midwifery === Auxiliary-Nursing-cum-Midwifery q9LzwSSI
AYUSH Multi Tasking Staff === AYUSH Multitasking Staff q9LzwSSI
Backoffice Support Executive === Back Office Support Executive q9LzwSSI
Bandman-cum-Guardsman === Bandman-cum-Guardman q9LzwSSI
Bariatric Co-ordinator === Bariatric Coordinator q9LzwSSI
Binder Grade II === Binder Grade-II q9LzwSSI
Binder Grade III === Binder Grade-III q9LzwSSI
Bindry Assistant === Bindery Assistant q9LzwSSI
Bio-Chemist === Biochemist q9LzwSSI
Bio Medical Engineer === Biomedical Engineer q9LzwSSI
Bio-Medical Engineer === Biomedical Engineer q9LzwSSI
Bio Medical Tecnician === Biomedical Technician q9LzwSSI
Bio-Safety Officer === Biosafety Officer q9LzwSSI
Blaster Gr-II === Blaster Grade-II q9LzwSSI
Block Data Manger === Block Data Manager q9LzwSSI
Block Date Manager === Block Data Manager q9LzwSSI
Block Level Assistant Accoutant === Block Level Assistant Accountant q9LzwSSI
Block Multi-Tasking Assistant === Block Multitasking Assistant q9LzwSSI
Block Public Health Manger === Block Public Health Manager q9LzwSSI
Block Resource Peron === Block Resource Person q9LzwSSI
Block Cum Screen Printer === Block-cum-Screen Printer q9LzwSSI
Blood Collection Officers === Blood Collection Officer q9LzwSSI
Bioler Man === Boiler Man q9LzwSSI
Boiler Operator and Machanic === Boiler Operator and Mechanic q9LzwSSI
Bunglow Watchers === Bunglow Watcher q9LzwSSI
Business Analysts === Business Analyst q9LzwSSI
Business Development Manager cum Centre Manager === Business Development Manager-cum-Centre Manager q9LzwSSI
Call Operators === Call Operator q9LzwSSI
Cameraman Grade II === Cameraman Grade-II q9LzwSSI
Care Taker === Caretaker q9LzwSSI
Care Taker cum cook === Caretaker-cum-cook q9LzwSSI
Caretaker cum Manager === Caretaker-cum-Manager q9LzwSSI
Caretaker-Cum-Office Assistant === Caretaker-cum-Office Assistant q9LzwSSI
Carpenter Grade II === Carpenter Grade-II q9LzwSSI
Carpenter-Cum-Artist === Carpenter-cum-Artist q9LzwSSI
Carpenter cum Mistri-II === Carpenter-cum-Mistri-II q9LzwSSI
Case Coordinator cum Liaison Officer === Case Coordinator-cum-Liaison Officer q9LzwSSI
Case Workers === Case Worker q9LzwSSI
Cashier Cum Accountant === Cashier-cum-Accountant q9LzwSSI
Cashier-Cum-Office Assistant === Cashier-cum-Office Assistant q9LzwSSI
Casual News Readers === Casual News Reader q9LzwSSI
Causality Medical Officer === Casualty Medical Officer q9LzwSSI
Casuality Medical Officer === Casualty Medical Officer q9LzwSSI
Cateloger === Cataloger q9LzwSSI
Cataloguing Experts === Cataloguing Expert q9LzwSSI
Certified Security Screeners === Certified Security Screener q9LzwSSI
Chaiperson === Chairperson q9LzwSSI
Charted Accountants === Chartered Accountants q9LzwSSI
Chartered Accountants === Chartered Accountant q9LzwSSI
Chartered Accountant-cum-Senior Account Officer === Chartered Accountant-cum-Senior Accounts Officer q9LzwSSI
Chest &Tuberculosis === Chest & Tuberculosis q9LzwSSI
Chick Sexer cum Hatchery Assistant === Chick Sexer-cum-Hatchery Assistant q9LzwSSI
Chief Account Officer === Chief Accounts Officer q9LzwSSI
Chief Consultants === Chief Consultant q9LzwSSI
Cheif Economist cum Senior Lead === Chief Economist-cum-Senior Lead q9LzwSSI
Chief Engineers === Chief Engineer q9LzwSSI
Chief Enginner === Chief Engineer q9LzwSSI
Chief Faculty Sr. Faculty Faculty Jr. Faculty === Chief Faculty Senior Faculty Faculty Junior Faculty q9LzwSSI
Chief Financial Officer cum Company Secretary === Chief Financial Officer-cum-Company Secretary q9LzwSSI
Cheif Hydrographer === Chief Hydrographer q9LzwSSI
Chief Superintendant === Chief Superintendent q9LzwSSI
Chief- Clinical Portfolio Management === Chief-Clinical Portfolio Management q9LzwSSI
Child Development Project Officers === Child Development Project Officer q9LzwSSI
Child Helpline Supervisors === Child Helpline Supervisor q9LzwSSI
chimney Sweeps === Chimney Sweeps q9LzwSSI
Chokidar cum mali === Chokidar-cum-mali q9LzwSSI
Chowkidar cum Gardner === Chowkidar-cum-Gardner q9LzwSSI
Choukidar cum mali === Chowkidar-cum-mali q9LzwSSI
Chowkidar cum mali === Chowkidar-cum-mali q9LzwSSI
Cinema Operator cum Publicity Assistant === Cinema Operator-cum-Publicity Assistant q9LzwSSI
Circle Based Officers === Circle Based Officer q9LzwSSI
Civil Judge Cum Judicial Magistrate === Civil Judge-cum-Judicial Magistrate q9LzwSSI
Civil Judge Cum Judicial Magistrate Grade III === Civil Judge-cum-Judicial Magistrate Grade-III q9LzwSSI
Civillian Assistant Programmer === Civilian Assistant Programmer q9LzwSSI
Civillian Trade Instructor === Civilian Trade Instructor q9LzwSSI
Civilian Trade Instructors === Civilian Trade Instructor q9LzwSSI
Class Room Attendent === Class Room Attendant q9LzwSSI
Clerical Assistant cum Accountant === Clerical Assistant-cum-Accountant q9LzwSSI
Clerks === Clerk q9LzwSSI
Clerk Grade I === Clerk Grade-I q9LzwSSI
Clerk Grade II === Clerk Grade-II q9LzwSSI
Clerk cum Accountant === Clerk-cum-Accountant q9LzwSSI
Clerk-cum- Data Entry Operator === Clerk-cum-Data Entry Operator q9LzwSSI
Clerk Cum Data Entry Operator === Clerk-cum-Data Entry Operator q9LzwSSI
Clerk-Cum-Date-Entry Operator === Clerk-cum-Data-Entry Operator q9LzwSSI
Clerk Cum Librarian === Clerk-cum-Librarian q9LzwSSI
Clerk cum Operator === Clerk-cum-Operator q9LzwSSI
Clerk Cum Telephone Operator === Clerk-cum-Telephone Operator q9LzwSSI
Clerk cum Typist === Clerk-cum-Typist q9LzwSSI
Clerk-Cum-Typist === Clerk-cum-Typist q9LzwSSI
Clerk cum Typist cum Computer === Clerk-cum-Typist-cum-Computer q9LzwSSI
Client Servicing Supervicor === Client Servicing Supervisor q9LzwSSI
Clinical Assistants === Clinical Assistant q9LzwSSI
Clinical Assistants (MR) === Clinical Assistant (MR) q9LzwSSI
Clinical Assistantship === Clinical Assistanthip q9LzwSSI
Clinical Associates === Clinical Associate q9LzwSSI
Clinical Psychologoist === Clinical Psychologist q9LzwSSI
Clinical Trial Co-ordinator === Clinical Trial Coordinator q9LzwSSI
Cluster Resource Persons === Cluster Resource Person q9LzwSSI
CNC Operators === CNC Operator q9LzwSSI
CNC Programmer cum Operator === CNC Programmer-cum-Operator q9LzwSSI
Coaches === Coach q9LzwSSI
Coding Keeper Cum Computer Operator === Coding Keeper-cum-Computer Operator q9LzwSSI
Collection Facilitators === Collection Facilitator q9LzwSSI
Commercial Executives === Commercial Executive q9LzwSSI
Commercial cum Ticket Clerk === Commercial-cum-Ticket Clerk q9LzwSSI
Common Recruitment Process Clerks-XI === Common Recruitment Process Clerk-XI q9LzwSSI
Communlty Health Assistant === Community Health Assistant q9LzwSSI
Community Health Assistan === Community Health Assistant q9LzwSSI
Community Health Officers === Community Health Officer q9LzwSSI
Company Secretarial - Executive === Company Secretarial-Executive q9LzwSSI
Company Secreatary === Company Secretary q9LzwSSI
Company Secretary cum Compliance Officer === Company Secretary-cum-Compliance Officer q9LzwSSI
Company Secretary cum Legal Advisor === Company Secretary-cum-Legal Advisor q9LzwSSI
Company Secretary cum Manager === Company Secretary-cum-Manager q9LzwSSI
Company Secretary-cum-Senior Account Officer === Company Secretary-cum-Senior Accounts Officer q9LzwSSI
Complier === Compiler q9LzwSSI
Composite Welders === Composite Welder q9LzwSSI
Compositor-Cum-Printer === Compositor-cum-Printer q9LzwSSI
Compunder === Compounder q9LzwSSI
Compounder (GCS, Group C (NG) Non- Ministerial) === Compounder (GCS, Group C (NG) Non-Ministerial) q9LzwSSI
Computer Assistant Grade II === Computer Assistant Grade-II q9LzwSSI
Computer Engineers === Computer Engineer q9LzwSSI
Computer Operator cum Accountant === Computer Operator-cum-Accountant q9LzwSSI
Computer Operator Cum Data Entry Manager === Computer Operator-cum-Data Entry Manager q9LzwSSI
Computer Operator cum Data Entry Operator === Computer Operator-cum-Data Entry Operator q9LzwSSI
Computer Operating Cum Programming Assistant === Computer Operator-cum-Programming Assistant q9LzwSSI
Computer Operator cum Typist === Computer Operator-cum-Typist q9LzwSSI
Computer Programmer Grade A === Computer Programmer Grade-A q9LzwSSI
Computer Programmer Cum Data Manager === Computer Programmer-cum-Data Manager q9LzwSSI
Concurrent Auditors === Concurrent Auditor q9LzwSSI
Confidential Assistant Grade II === Confidential Assistant Grade-II q9LzwSSI
Conusltant === Consultant q9LzwSSI
Consultnat === Consultant q9LzwSSI
Counsultant === Consultant q9LzwSSI
Consulant === Consultant q9LzwSSI
Consultants === Consultant q9LzwSSI
Consultant (Non-Tech) - Grade-II === Consultant (Non-Tech)-Grade-II q9LzwSSI
Consultant (Tech) - Grade-I === Consultant (Tech)-Grade-I q9LzwSSI
Consultant Cardio Vascular Thoracic Surgeon === Consultant Cardiovascular Thoracic Surgeon q9LzwSSI
Consultant Grade 1 === Consultant Grade-1 q9LzwSSI
Consultant Grade 2 === Consultant Grade-2 q9LzwSSI
Consultant Grade I === Consultant Grade-I q9LzwSSI
Consultant Grade II === Consultant Grade-II q9LzwSSI
Consultant Grade III === Consultant Grade-III q9LzwSSI
Consultant Hindi Translator cum Typist === Consultant Hindi Translator-cum-Typist q9LzwSSI
Consulant Lower Division Clerk === Consultant Lower Division Clerk q9LzwSSI
Consultant Postition-I === Consultant Position-I q9LzwSSI
Consultant Postition-II === Consultant Position-II q9LzwSSI
Consultant Rediographer === Consultant Radiographer q9LzwSSI
Consultant â€“ Chief General Manager === Consultant-Chief General Manager q9LzwSSI
Consultant cum Special Rapporteur === Consultant-cum-Special Rapporteur q9LzwSSI
Consultant-Grade I === Consultant-Grade-I q9LzwSSI
Consultant-Grade II === Consultant-Grade-II q9LzwSSI
Consultant -Medical Officer (Male) === Consultant-Medical Officer (Male) q9LzwSSI
Consultants/ Young Professionals === Consultant/ Young Professional q9LzwSSI
Content Creator cum Social Media Handler === Content Creator-cum-Social Media Handler q9LzwSSI
Content Creator Cum Writer === Content Creator-cum-Writer q9LzwSSI
Content Manager Cum Social Media Manager === Content Manager-cum-Social Media Manager q9LzwSSI
Content Writer Cum Journalist === Content Writer-cum-Journalist q9LzwSSI
Contract Medical Practioner === Contract Medical Practitioner q9LzwSSI
Contract Medical Practitioners === Contract Medical Practitioner q9LzwSSI
Controller of  Examination === Controller of Examination q9LzwSSI
Controller of  Examinations === Controller of Examinations q9LzwSSI
Conventional Milling mahine Operator === Conventional Milling machine Operator q9LzwSSI
Cook Grade II === Cook Grade-II q9LzwSSI
Cook Cum Attendant === Cook-cum-Attendant q9LzwSSI
Cook-Cum-Bearer === Cook-cum-Bearer q9LzwSSI
Cook cum Cake Taker === Cook-cum-Cake Taker q9LzwSSI
Cook Cum Caretaker === Cook-cum-Caretaker q9LzwSSI
Cooks Cum Helper === Cooks-cum-Helper q9LzwSSI
Co-ordinator Grade IV === Coordinator Grade-IV q9LzwSSI
Coordinator cum Associate Professor === Coordinator-cum-Associate Professor q9LzwSSI
Copper Smith and Sheet Metal Worker === Coppersmith and Sheet Metal Worker q9LzwSSI
Copy writer === Copywriter q9LzwSSI
Corporate Communication Associate cum Executive Assistant === Corporate Communication Associate-cum-Executive Assistant q9LzwSSI
Cost Accountants === Cost Accountant q9LzwSSI
Cost and Management Accountant Trainees === Cost and Management Accountant Trainee q9LzwSSI
Cost and Management Trainees === Cost and Management Trainee q9LzwSSI
Counsels === Counsel q9LzwSSI
Counselling Psychologists === Counselling Psychologist q9LzwSSI
Counselling  Superintendent === Counselling Superintendent q9LzwSSI
Counsellors District NCD Clinic === Counsellor District NCD Clinic q9LzwSSI
Councellor === Counselor q9LzwSSI
Court Master/Stenographer === Court Master/ Stenographer q9LzwSSI
Court Officers/ Section Officers === Court Officer/ Section Officer q9LzwSSI
Crane Opearator === Crane Operator q9LzwSSI
CRC Executives === CRC Executive q9LzwSSI
Credit Officers === Credit Officer q9LzwSSI
CSR Technician Grade II === CSR Technician Grade-II q9LzwSSI
Custodian Cum Data Entry Operator === Custodian-cum-Data Entry Operator q9LzwSSI
Dafatry === Daftary q9LzwSSI
Data Analysts === Data Analyst q9LzwSSI
Data  Collector === Data Collector q9LzwSSI
Data Entry Officer cum Supervisor === Data Entry Officer-cum-Supervisor q9LzwSSI
Data Entery Operator === Data Entry Operator q9LzwSSI
Date Entry Operator === Data Entry Operator q9LzwSSI
Data Entry Operators === Data Entry Operator q9LzwSSI
Data Entry Operator Grade A === Data Entry Operator Grade-A q9LzwSSI
Data Entry Operators Grade A === Data Entry Operators Grade-A q9LzwSSI
Data Entry Operator Grade -B === Data Entry Operator Grade-B q9LzwSSI
Data Entry Operator (Grade B) === Data Entry Operator Grade-B q9LzwSSI
Data Entry Operator Grade B === Data Entry Operator Grade-B q9LzwSSI
Data Entry Operators Grade B === Data Entry Operators Grade-B q9LzwSSI
Data Entry Operator Grade C === Data Entry Operator Grade-C q9LzwSSI
Data Entry Operator Grade D === Data Entry Operator Grade-D q9LzwSSI
Data Entry Operator- B === Data Entry Operator-B q9LzwSSI
Data Entry Operator Cum Accountant === Data Entry Operator-cum-Accountant q9LzwSSI
Data Entry Operator Cum Accountant Cum Clerk === Data Entry Operator-cum-Accountant-cum-Clerk q9LzwSSI
Data Entry Operator cum Field Assistant === Data Entry Operator-cum-Field Assistant q9LzwSSI
Data Entry Operator cum Multitask Person === Data Entry Operator-cum-Multitask Person q9LzwSSI
Data Entry Operator cum Registration Clerk === Data Entry Operator-cum-Registration Clerk q9LzwSSI
Data Entry Operator cum Telecaller === Data Entry Operator-cum-Telecaller q9LzwSSI
2 Data Management Staff === Data Management Staff q9LzwSSI
Data Manager cum Statistician === Data Manager-cum-Statistician q9LzwSSI
Data Manager cum trial Coordinator === Data Manager-cum-trial Coordinator q9LzwSSI
Data Mining Experts === Data Mining Expert q9LzwSSI
Data Cum Finance Manager === Data-cum-Finance Manager q9LzwSSI
Datebase Admin === Database Admin q9LzwSSI
Data Base Administrator === Database Administrator q9LzwSSI
Database Administrator-Cum-Programmer === Database Administrator-cum-Programmer q9LzwSSI
Database Developer â€“ MYSQL === Database Developer-MYSQL q9LzwSSI
Database Developer â€“ SQL Server === Database Developer-SQL Server q9LzwSSI
Database Experts === Database Expert q9LzwSSI
DBA â€“ MYSQL === DBA-MYSQL q9LzwSSI
Degree Apprentice Trainees === Degree Apprentice Trainee q9LzwSSI
Demonstator === Demonstrator q9LzwSSI
Demonstrators === Demonstrator q9LzwSSI
Dental Assistant/Dental Mechanic Grade III === Dental Assistant/Dental Mechanic Grade-III q9LzwSSI
Dental Hygieneist === Dental Hygienist q9LzwSSI
Dental Hygienist Grade II === Dental Hygienist Grade-II q9LzwSSI
Dental Surgeon-cum Clinical Tutors === Dental Surgeon-cum Clinical Tutor q9LzwSSI
Dental Techician === Dental Technician q9LzwSSI
Dental Technician Grade II === Dental Technician Grade-II q9LzwSSI
Deputy Central Intelligence Officer/Tech- Telephone === Deputy Central Intelligence Officer/Tech-Telephone q9LzwSSI
Dy. Chief Fire Officer/A === Deputy Chief Fire Officer/A q9LzwSSI
Deputy Chief Security Offcer === Deputy Chief Security Officer q9LzwSSI
Deputy Directo === Deputy Director q9LzwSSI
Dy. Director === Deputy Director q9LzwSSI
Dcputy Dircctor === Deputy Director q9LzwSSI
Depurty Director === Deputy Director q9LzwSSI
Deputy  Director === Deputy Director q9LzwSSI
Dy. Director (Law/Eco) === Deputy Director (Law/Eco) q9LzwSSI
Dy. Director General === Deputy Director General q9LzwSSI
Deputy Director Horticultuture === Deputy Director Horticulture q9LzwSSI
Deputy District Education Medica Officer === Deputy District Education Medical Officer q9LzwSSI
Dy. Engineer-I === Deputy Engineer-I q9LzwSSI
Dy. Engineer-I (MEP) === Deputy Engineer-I (MEP) q9LzwSSI
Dy. Executive Director-II === Deputy Executive Director-II q9LzwSSI
Dy. General Manager === Deputy General Manager q9LzwSSI
Dy. General Manager/ Architect === Deputy General Manager/ Architect q9LzwSSI
Dy. General Manager/Information Technology === Deputy General Manager/Information Technology q9LzwSSI
Dy.General manager/Legal === Deputy General Manager/Legal q9LzwSSI
Deputy Industrial Advior === Deputy Industrial Advisor q9LzwSSI
Deputy Legal Advisor cum General Counsel === Deputy Legal Advisor-cum-General Counsel q9LzwSSI
Dy. Manager === Deputy Manager q9LzwSSI
Dy.Manager === Deputy Manager q9LzwSSI
Deputy Manager cum Executive Assistant === Deputy Manager-cum-Executive Assistant q9LzwSSI
Dupty Officer === Deputy Officer q9LzwSSI
Deputy Project  Manager === Deputy Project Manager q9LzwSSI
Dy. Registrar === Deputy Registrar q9LzwSSI
Deputy Superintendant === Deputy Superintendent q9LzwSSI
Deputy Superitendent of Police === Deputy Superintendent of Police q9LzwSSI
Dy. Town planner === Deputy Town planner q9LzwSSI
Deput/Regional Enforcement Officer === Deputy/Regional Enforcement Officer q9LzwSSI
Designer cum DTP operator === Designer-cum-DTP operator q9LzwSSI
Desk Top Publisher Operator Instructor === Desktop Publisher Operator Instructor q9LzwSSI
Developer â€“ Python === Developer-Python q9LzwSSI
Developer/ Programmers === Developer/ Programmer q9LzwSSI
Development and Communication- Officer CUM Public relation Officer === Development and Communication Officer-cum-Public Relation Officer q9LzwSSI
Development and Communication Officer CUM Public Relation Officer === Development and Communication Officer-cum-Public Relation Officer q9LzwSSI
Diesel Cum Motor Mechanic === Diesel-cum-Motor Mechanic q9LzwSSI
Dietician Grade III === Dietician Grade-III q9LzwSSI
Dietician Cum Counselor === Dietician-cum-Counselor q9LzwSSI
Dietcian === Dietitian q9LzwSSI
Digital Marketing Interns === Digital Marketing Intern q9LzwSSI
Diploma Appretince === Diploma Apprentice q9LzwSSI
Diploma Apprentices === Diploma Apprentice q9LzwSSI
Diploma Apprentice Trainees === Diploma Apprentice Trainee q9LzwSSI
Diploma Apprenticeship === Diploma Apprenticehip q9LzwSSI
Diploma Trainees === Diploma Trainee q9LzwSSI
Director Ministrial === Director Ministerial q9LzwSSI
Director cum Advisor === Director-cum-Advisor q9LzwSSI
Director/Principle === Director/Principal q9LzwSSI
Disaster  Management === Disaster Management q9LzwSSI
Dispensing Attendants === Dispensing Attendant q9LzwSSI
Dissection Hall Attendent === Dissection Hall Attendant q9LzwSSI
Discation Hall Attendant === Dissection Hall Attendant q9LzwSSI
District Basik Shiksha Adhikari === District Basic Shiksha Adhikari q9LzwSSI
District PMDT & TBHIV Coordinator === District PMDT & TB HIV Coordinator q9LzwSSI
District PMDT and TBHIV Coordinator === District PMDT and TB HIV Coordinator q9LzwSSI
District Pro MIS Operator Cum Store Keeper === District Pro MIS Operator-cum-Store Keeper q9LzwSSI
District Probation Officer Grade II === District Probation Officer Grade-II q9LzwSSI
Trained Gradudate Teacher === District Programme coordinator q9LzwSSI
District Programmer coordinator === District Programme coordinator q9LzwSSI
District Programme Cum Administrative Assistant === District Programme-cum-Administrative Assistant q9LzwSSI
District Resource Persons === District Resource Person q9LzwSSI
District SBM Cum SLWM Coordinator === District SBM-cum-SLWM Coordinator q9LzwSSI
District Welfare cum probation Officer === District Welfare-cum-probation Officer q9LzwSSI
Docotor === Doctor q9LzwSSI
Doctors === Doctor q9LzwSSI
Doctoral Fellowships === Doctoral Fellowhips q9LzwSSI
Domain Expert cum Project Coordinator === Domain Expert-cum-Project Coordinator q9LzwSSI
Dope Control Officers === Dope Control Officer q9LzwSSI
Doping Control Officers === Doping Control Officer q9LzwSSI
DR TB Centre Councsellor === DR TB Centre Counsellor q9LzwSSI
Draftsman Grade I === Draftsman Grade-I q9LzwSSI
Draftsman Grade II === Draftsman Grade-II q9LzwSSI
Draftsman Grade -III === Draftsman Grade-III q9LzwSSI
Draftsman Grade III === Draftsman Grade-III q9LzwSSI
Draftsman Cum Instructor === Draftsman-cum-Instructor q9LzwSSI
Draughts Man === Draughtsman q9LzwSSI
Draughtman === Draughtsman q9LzwSSI
Draughts-man === Draughtsman q9LzwSSI
Draughtsman Grade II === Draughtsman Grade-II q9LzwSSI
Draughtsman Grade-lI === Draughtsman Grade-II q9LzwSSI
Dresser-Cum-Attendant === Dresser-cum-Attendant q9LzwSSI
Dresser cum Compounder === Dresser-cum-Compounder q9LzwSSI
Driller- Cum - Mechanic === Driller-cum-Mechanic q9LzwSSI
Drivers === Driver q9LzwSSI
Drivers (Class-III) === Driver (Class-III) q9LzwSSI
Driver (Grade-II) === Driver Grade-II q9LzwSSI
Driver Grade II === Driver Grade-II q9LzwSSI
Driver (Grade -III) === Driver Grade-III q9LzwSSI
Driver Cum Attendant === Driver-cum-Attendant q9LzwSSI
Driver cum Office Assistant === Driver-cum-Office Assistant q9LzwSSI
Driver-Cum-Office Attendant === Driver-cum-Office Attendant q9LzwSSI
Driver Cum Office Attendant === Driver-cum-Office Attendant q9LzwSSI
Driver cum peon === Driver-cum-peon q9LzwSSI
Driver-Cum-Pump === Driver-cum-Pump q9LzwSSI
Driver Cum Pump Operator cum Fireman === Driver-cum-Pump Operator-cum-Fireman q9LzwSSI
Driver-cum-Pump Operator- cum-Fireman/A === Driver-cum-Pump Operator-cum-Fireman/A q9LzwSSI
Driver-Cum-Pump-Operator-Cum-Fireman === Driver-cum-Pump-Operator-cum-Fireman q9LzwSSI
Driver Cum Security Guard === Driver-cum-Security Guard q9LzwSSI
Driverâ€“II === Driver-II q9LzwSSI
Drug De-Addiction Councillor === Drug De-Addiction Counselor q9LzwSSI
E -Tendering Professional === E-Tendering Professional q9LzwSSI
Early Intervention cum Special Educator === Early Intervention-cum-Special Educator q9LzwSSI
Early Interventionist cum Special Educator === Early Interventionist-cum-Special Educator q9LzwSSI
Early Interventionist â€“cum- Special Educator === Early Interventionist-cum-Special Educator q9LzwSSI
Economist cum Access to Finance Advisor === Economist-cum-Access to Finance Advisor q9LzwSSI
Educational and Vocational Guidance  Counselor (EVGC)- Female === Educational and Vocational Guidance Counselor (EVGC)-Female q9LzwSSI
Educational and Vocational Guidance  Counselor (EVGC) - Male === Educational and Vocational Guidance Counselor (EVGC)-Male q9LzwSSI
Educators === Educator q9LzwSSI
Educator Cum Studio Assistant === Educator-cum-Studio Assistant q9LzwSSI
Electrical Insturctor-cum-Technician === Electrical Instructor-cum-Technician q9LzwSSI
Electrician Grade I === Electrician Grade-I q9LzwSSI
Electrician Grade II === Electrician Grade-II q9LzwSSI
Electrician Gr-III === Electrician Grade-III q9LzwSSI
Electrician cum Plumber === Electrician-cum-Plumber q9LzwSSI
Electrician cum Trainer === Electrician-cum-Trainer q9LzwSSI
Electrician /WiremenElectrician /Wiremen === Electrician/Wireman q9LzwSSI
Electricity Workers === Electricity Worker q9LzwSSI
Electro Cardiograph Technical Assistant === Electrocardiograph Technical Assistant q9LzwSSI
Electrocardiogr aphic Technical Assistant === Electrocardiographic Technical Assistant q9LzwSSI
Eiectroplater === Electroplater q9LzwSSI
E-Mail Administrator === Email Administrator q9LzwSSI
Emergence Response Officer === Emergency Response Officer q9LzwSSI
End Point Security Manager === Endpoint Security Manager q9LzwSSI
Engagement Managers === Engagement Manager q9LzwSSI
Engine Driver -II === Engine Driver-II q9LzwSSI
Engine Room Ratings === Engine Room Rating q9LzwSSI
Engineers === Engineer q9LzwSSI
Engineer and Ship Surveyor-Cum-Deputy Director General === Engineer and Ship Surveyor-cum-Deputy Director General q9LzwSSI
Engineer and Ship Surveyor- Cum-Deputy Director General === Engineer and Ship Surveyor-cum-Deputy Director General q9LzwSSI
Engineer Specialist (Grade-I) === Engineer Specialist Grade-I q9LzwSSI
Engineer - C === Engineer-C q9LzwSSI
Enigineer-in-Charge === Engineer-in-Charge q9LzwSSI
Enginnering Assistant === Engineering Assistant q9LzwSSI
Engineering Assistant Grade II === Engineering Assistant Grade-II q9LzwSSI
Engineering Executive Trainees === Engineering Executive Trainee q9LzwSSI
Engineering Officer Grade I === Engineering Officer Grade-I q9LzwSSI
ENT Surgeons === ENT Surgeon q9LzwSSI
Entrepreneur Trainees === Entrepreneur Trainee q9LzwSSI
Environmental Specialist Ganga cum Arth Ganga Specialist === Environmental Specialist Ganga-cum-Arth Ganga Specialist q9LzwSSI
EPBAX Assistant === EPABX Assistant q9LzwSSI
EBPAX Operator === EPABX Operator q9LzwSSI
Epidemiologist-cum-Assistant Proessor === Epidemiologist-cum-Assistant Professor q9LzwSSI
Epidemiologist Cum Assistant Professor === Epidemiologist-cum-Assistant Professor q9LzwSSI
Estate Managers === Estate Manager q9LzwSSI
Estate Manager cum Maintenance === Estate Manager-cum-Maintenance q9LzwSSI
Estate Manager cum Security Officer === Estate Manager-cum-Security Officer q9LzwSSI
Estate cum Project Officer === Estate-cum-Project Officer q9LzwSSI
Ethical Hackers & Penetration Testers === Ethical Hackers & Penetration Tester q9LzwSSI
Ex Bank officials === Ex Bank official q9LzwSSI
Executives === Executive q9LzwSSI
Executive Administrative Assistant cum Secretary === Executive Administrative Assistant-cum-Secretary q9LzwSSI
Executive Assistants === Executive Assistant q9LzwSSI
Executive Assistant â€“I === Executive Assistant-I q9LzwSSI
Executive  Engineer === Executive Engineer q9LzwSSI
Executive Gr. I === Executive Grade-I q9LzwSSI
Executive Gr. II === Executive Grade-II q9LzwSSI
Executive Gr. III === Executive Grade-III q9LzwSSI
Executive Gr. IV === Executive Grade-IV q9LzwSSI
Executive Gr. V === Executive Grade-V q9LzwSSI
Executive Gr. VI === Executive Grade-VI q9LzwSSI
Executive Officer Grade IV === Executive Officer Grade-IV q9LzwSSI
Executive Trainees === Executive Trainee q9LzwSSI
Exhibitiion Officer === Exhibition Officer q9LzwSSI
Expert Mamber === Expert Member q9LzwSSI
Expert Members === Expert Member q9LzwSSI
Extension  Officer === Extension Officer q9LzwSSI
Facilitators === Facilitator q9LzwSSI
Farm Assistant Grade II === Farm Assistant Grade-II q9LzwSSI
Farm Attendant Cum Labour === Farm Attendant-cum-Labour q9LzwSSI
Farm Officer Grade II === Farm Officer Grade-II q9LzwSSI
Farmers Friends === Farmers Friend q9LzwSSI
Feed Mill Clerk cum Typist === Feed Mill Clerk-cum-Typist q9LzwSSI
Feed mill Manaser === Feed mill Manager q9LzwSSI
Fellows === Fellow q9LzwSSI
Fellowship === Fellowhip q9LzwSSI
Female Attendent === Female Attendant q9LzwSSI
Female Supervlsor === Female Supervisor q9LzwSSI
Field Assistant/Interns === Field Assistant/Intern q9LzwSSI
Field Assistants/Technical Assistants === Field Assistant/Technical Assistant q9LzwSSI
Field Co-ordinator === Field Coordinator q9LzwSSI
Field Engineers === Field Engineer q9LzwSSI
Field Enumerators === Field Enumerator q9LzwSSI
Filed Investigator === Field Investigator q9LzwSSI
Field Investigators === Field Investigator q9LzwSSI
Field Investigator Cum Technician === Field Investigator-cum-Technician q9LzwSSI
Field Level Investigators === Field Level Investigator q9LzwSSI
Field Officer cum Counsellor === Field Officer-cum-Counsellor q9LzwSSI
Filed Worker === Field Worker q9LzwSSI
Field Cum Lab Assistant === Field-cum-Lab Assistant q9LzwSSI
Field Cum Lab attendant === Field-cum-Lab attendant q9LzwSSI
Field-cum- Laboratory Assistant === Field-cum-Laboratory Assistant q9LzwSSI
Field cum Laboratory Assistant === Field-cum-Laboratory Assistant q9LzwSSI
Field-Cum-Laboratory Attendant === Field-cum-Laboratory Attendant q9LzwSSI
Field Cum Laboratory Attendant === Field-cum-Laboratory Attendant q9LzwSSI
Finance and Account Consultant === Finance and Accounts Consultant q9LzwSSI
Finance and Account Officer === Finance and Accounts Officer q9LzwSSI
Finance & Account Officer === Finance & Accounts Officer q9LzwSSI
Finance and Chief Account Officer === Finance and Chief Accounts Officer q9LzwSSI
Finance Co-ordinator === Finance Coordinator q9LzwSSI
Finance cum Accounts Officer === Finance-cum-Accounts Officer q9LzwSSI
Financial Literacy Councillor === Financial Literacy Counsellor q9LzwSSI
Financial Literacy Counselor === Financial Literacy Counsellor q9LzwSSI
Finger Print Examiner === Fingerprint Examiner q9LzwSSI
Finger Print Expert === Fingerprint Expert q9LzwSSI
Fire operator cum driver === Fire operator-cum-driver q9LzwSSI
Fire-Cum-Security Officer === Fire-cum-Security Officer q9LzwSSI
Fireman -A === Fireman-A q9LzwSSI
light Operations Inspector === Flight Operations Inspector q9LzwSSI
Flute cum Shehnai Player === Flute-cum-Shehnai Player q9LzwSSI
Foremnan === Foreman q9LzwSSI
Foreman Grade I === Foreman Grade-I q9LzwSSI
Forest Range Officer Grade I === Forest Range Officer Grade-I q9LzwSSI
Forest Rangers === Forest Ranger q9LzwSSI
Fork Lift Operator === Forklift Operator q9LzwSSI
Front Office Councellor === Front Office Counselor q9LzwSSI
Front Office Councilor === Front Office Counselor q9LzwSSI
Front Office Executive cum Registration Assistant === Front Office Executive-cum-Registration Assistant q9LzwSSI
Fullstack Developer === Full Stack Developer q9LzwSSI
Full time Counseling Psychologists === Full time Counseling Psychologist q9LzwSSI
Full Time Grade II Audiologist and Speech therapist === Full Time Grade-II Audiologist and Speech therapist q9LzwSSI
Full Time Neuro Surgeon === Full Time Neurosurgeon q9LzwSSI
Full  Time Specialist === Full Time Specialist q9LzwSSI
Full Time Specialists === Full Time Specialist q9LzwSSI
Full Time Sports Coaches & Instructors === Full Time Sports Coach & Instructor q9LzwSSI
Full Time Super Specialists === Full Time Super Specialist q9LzwSSI
Fulltime Young Legal Professional === Full Time Young Legal Professional q9LzwSSI
full time/part time specialist === full time/part time Specialist q9LzwSSI
Full Time/Part Time Specialists === Full Time/Part Time Specialist q9LzwSSI
Fund Adudit Assistant === Fund Audit Assistant q9LzwSSI
Games Coaches& Dance === Games Coaches & Dance q9LzwSSI
Gas Pipe Line operator === Gas Pipeline operator q9LzwSSI
Gate Keeper === Gatekeeper q9LzwSSI
General Duty Doctors === General Duty Doctor q9LzwSSI
General  Duty Medical  Officer === General Duty Medical Officer q9LzwSSI
General Duty Medica Officer === General Duty Medical Officer q9LzwSSI
General Duty Medical Officers === General Duty Medical Officer q9LzwSSI
General duty Medical Officer Gr-II === General duty Medical Officer Grade-II q9LzwSSI
General Fellowship/Post Doctoral Fellowship === General Fellowhip/PostdoctoralFellowhip q9LzwSSI
General Maintenance Mechanic cum Trainer === General Maintenance Mechanic-cum-Trainer q9LzwSSI
General Manger === General Manager q9LzwSSI
General Manager/ Addl.General Manager/Sr. Dy. General Manager === General Manager/ Addl.General Manager/Senior Deputy General Manager q9LzwSSI
General Manager/Dy. Chief Project Manager === General Manager/Deputy Chief Project Manager q9LzwSSI
eneral Nursing and Midwifery === General Nursing and Midwifery q9LzwSSI
Girl Cadet Instructors === Girl Cadet Instructor q9LzwSSI
GIS - Database Administrator === GIS-Database Administrator q9LzwSSI
Glazer-Cum-Trimmer === Glazer-cum-Trimmer q9LzwSSI
Graduate Appretince === Graduate Apprentice q9LzwSSI
Graduate Apprentices === Graduate Apprentice q9LzwSSI
Graduate Apprenti ce === Graduate Apprentice q9LzwSSI
Graduate Apprentices Trainee === Graduate Apprentice Trainee q9LzwSSI
Graduate Apprenticeship === Graduate Apprenticehip q9LzwSSI
Graduate Apprenticeship Trainees === Graduate Apprenticehip Trainee q9LzwSSI
Graduate Apprenticeship Trainee === Graduate Apprenticehip Trainee q9LzwSSI
Graduate Engineers === Graduate Engineer q9LzwSSI
Graduate Engineering Apprentices === Graduate Engineering Apprentice q9LzwSSI
Graduate Engineering Trainees === Graduate Engineering Trainee q9LzwSSI
Graduate Technical Apprenticeship Trainee === Graduate Technical Apprenticehip Trainee q9LzwSSI
Graphic Designer cum Video Editor === Graphic Designer-cum-Video Editor q9LzwSSI
Graphics cum Social Media === Graphics-cum-Social Media q9LzwSSI
Grounds-man === Groundsman q9LzwSSI
Grounds man === Groundsman q9LzwSSI
Ground Water Expert === Groundwater Expert q9LzwSSI
Ground Water Expert cum Team leader === Groundwater Expert-cum-Team leader q9LzwSSI
Gynaec Oncology === Gynae Oncology q9LzwSSI
Gynologiest === Gynecologist q9LzwSSI
Hair Dresser === Hairdresser q9LzwSSI
Halwai Cum Cook === Halwai-cum-Cook q9LzwSSI
Handywomen === Handywoman q9LzwSSI
Harmonium Accompanists === Harmonium Accompanist q9LzwSSI
Havilder === Havildar q9LzwSSI
Havildar X-Ray Assistant === Havildar X-ray Assistant q9LzwSSI
Head Account Opening Dept === Head Accounts Opening Dept q9LzwSSI
Head Constable Driver (Grade-II) === Head Constable Driver Grade-II q9LzwSSI
Head Draftsmen === Head Draftsman q9LzwSSI
Head- Division of Epidemiology Diseases Communicable (ECD) === Head-Division of Epidemiology Diseases Communicable (ECD) q9LzwSSI
Head- Division of NonCommunicable Diseases (NCD) === Head-Division of NonCommunicable Diseases (NCD) q9LzwSSI
Head - Division of Reproductive Biology Maternal Health & Child Health === Head-Division of Reproductive Biology Maternal Health & Child Health q9LzwSSI
Head- Research and Innovation === Head-Research and Innovation q9LzwSSI
Head- Wealth Strategist === Head-Wealth Strategist q9LzwSSI
Headmaster cum School Administrator === Headmaster-cum-School Administrator q9LzwSSI
Head Master/ Headmistress === Headmaster/ Headmistress q9LzwSSI
Headmistress cum School Administrator === Headmistress-cum-School Administrator q9LzwSSI
Health & Malaria Inspector Grade III === Health & Malaria Inspector Grade-III q9LzwSSI
Hearing Officers === Hearing Officer q9LzwSSI
Heliport Manager cum Operations Incharge === Heliport Manager-cum-Operations Incharge q9LzwSSI
Helper-Cum-Night Watchman === Helper-cum-Night Watchman q9LzwSSI
Helper cum Night Watchman === Helper-cum-Night Watchman q9LzwSSI
HEM Mechanic Gr-III === HEM Mechanic Grade-III q9LzwSSI
Highly Skilled X-Ray Electrician === Highly Skilled X-ray Electrician q9LzwSSI
Hindi Translator Gr-II === Hindi Translator Grade-II q9LzwSSI
Hind Typist === Hindi Typist q9LzwSSI
Histo-Pathology Technician === Histopathology Technician q9LzwSSI
HIV Supervisior === HIV Supervisor q9LzwSSI
Homeopathic Specialists === Homeopathic Specialist q9LzwSSI
Homoeopathy  Doctor === Homoeopathy Doctor q9LzwSSI
Hospital Attendant Grade III === Hospital Attendant Grade-III q9LzwSSI
Hospital Care Taker === Hospital Caretaker q9LzwSSI
Hospital Multi Tasking Staff === Hospital Multitasking Staff q9LzwSSI
Hostel Superintendent cum Physical Training Instructor === Hostel Superintendent-cum-Physical Training Instructor q9LzwSSI
Hostel Welfare Officer Grade I === Hostel Welfare Officer Grade-I q9LzwSSI
Hostel Welfare Officer Grade II === Hostel Welfare Officer Grade-II q9LzwSSI
House Keepers === House Keeper q9LzwSSI
House Surgeons === House Surgeon q9LzwSSI
House Keeper === Housekeeper q9LzwSSI
House Keeper Grade II === Housekeeper Grade-II q9LzwSSI
House Keeping === Housekeeping q9LzwSSI
House Keeping Officer === Housekeeping Officer q9LzwSSI
House Keeping Staff === Housekeeping Staff q9LzwSSI
House Keeping Staff (HKS) === Housekeeping Staff (HKS) q9LzwSSI
Housekeeping Staff cum Attender === Housekeeping Staff-cum-Attender q9LzwSSI
House Staffship === Housestaffship q9LzwSSI
iHub Faculty Fellowship === iHub Faculty Fellowhip q9LzwSSI
Importer -Exporter Code Coordinator === Importer-Exporter Code Coordinator q9LzwSSI
Individual Experts === Individual Expert q9LzwSSI
Information Assistant Cum Account Assistant === Information Assistant-cum-Accounts Assistant q9LzwSSI
Information Technology and Systems Trainees === Information Technology and Systems Trainee q9LzwSSI
Information technology  Manager === Information technology Manager q9LzwSSI
Information Technology Support cum designer === Information Technology Support-cum-designer q9LzwSSI
Inquiry Officers === Inquiry Officer q9LzwSSI
Inseminator cum Data Recorder === Inseminator-cum-Data Recorder q9LzwSSI
Insight Lead - Fashion === Insight Lead-Fashion q9LzwSSI
Inspectors === Inspector q9LzwSSI
Inspector Boiler Grade I === Inspector Boiler Grade-I q9LzwSSI
Inspector Boiler Grade II === Inspector Boiler Grade-II q9LzwSSI
Inspector of Factories and Boilers Grade II === Inspector of Factories and Boilers Grade-II q9LzwSSI
Institute Post Doctoral Fellow === Institute PostdoctoralFellow q9LzwSSI
Institute Post-Doctoral Fellow === Institute Postdoctoral Fellow q9LzwSSI
Instructor Grade -I === Instructor Grade-I q9LzwSSI
Instructor Grade II === Instructor Grade-II q9LzwSSI
lnsurance Medical Officer === Insurance Medical Officer q9LzwSSI
Interns === Intern q9LzwSSI
Interns Lab Analyst === Intern Lab Analyst q9LzwSSI
Internal Auditor cum Advisor === Internal Auditor-cum-Advisor q9LzwSSI
Internship === Internhip q9LzwSSI
Internship Coordinator === Internhip Coordinator q9LzwSSI
Internship Trainee === Internhip Trainee q9LzwSSI
Interviewers === Interviewer q9LzwSSI
Syce === Invalid value q9LzwSSI
TOPASS === Invalid value q9LzwSSI
Investigator Cum Computer === Investigator-cum-Computer q9LzwSSI
Investment Analysts === Investment Analyst q9LzwSSI
Investment Associates === Investment Associate q9LzwSSI
Investment Managers === Investment Manager q9LzwSSI
IPR Associates === IPR Associate q9LzwSSI
IT-Cum-VC Supervisor === IT-cum-VC Supervisor q9LzwSSI
ITI Apprentice Trainees === ITI Apprentice Trainee q9LzwSSI
ITI Apprenticeship === ITI Apprenticehip q9LzwSSI
ITI Trade Apprenticeship === ITI Trade Apprenticehip q9LzwSSI
JACT/Care Taker === JACT/Caretaker q9LzwSSI
Joint Association of Classical Teachers === Joint Association of Classical Teacher q9LzwSSI
Joint General Manger === Joint General Manager q9LzwSSI
Judicial Magistrate Grade III === Judicial Magistrate Grade-III q9LzwSSI
Judicial Members === Judicial Member q9LzwSSI
Judicary Services === Judiciary Services q9LzwSSI
Judo Karate cum Martial Art Trainer === Judo Karate-cum-Martial Art Trainer q9LzwSSI
Junior Accoutant === Junior Accountant q9LzwSSI
Junior Accountant Grade II === Junior Accountant Grade-II q9LzwSSI
Junior Accountant Gr.II === Junior Accountant Grade-II q9LzwSSI
Junior Accountant cum Storekeeper === Junior Accountant-cum-Storekeeper q9LzwSSI
Junior Account Assistant === Junior Accounts Assistant q9LzwSSI
Junior Account Assistant cum Typist === Junior Accounts Assistant-cum-Typist q9LzwSSI
Junior Account Officer === Junior Accounts Officer q9LzwSSI
Junior Administrative Assistant Cum Program Assistant === Junior Administrative Assistant-cum-Program Assistant q9LzwSSI
Junior Administrative cum Accounts Officer === Junior Administrative-cum-Accounts Officer q9LzwSSI
Junior Apprenticeship and Placement Officer === Junior Apprenticehip and Placement Officer q9LzwSSI
Jr. Artist === Junior Artist q9LzwSSI
Junior Assisant === Junior Assistant q9LzwSSI
Junior Assistants === Junior Assistant q9LzwSSI
Jr. Assistant === Junior Assistant q9LzwSSI
Junior Assistant & Junior Assistant Cum Caretaker === Junior Assistant & Junior Assistant-cum-Caretaker q9LzwSSI
Junior Assistant Grade II === Junior Assistant Grade-II q9LzwSSI
Junior Assistant cum Caretaker === Junior Assistant-cum-Caretaker q9LzwSSI
Junior Assistant cum Computer Data Entry Operator === Junior Assistant-cum-Computer Data Entry Operator q9LzwSSI
Junior Assistant- cum- Computer Operator === Junior Assistant-cum-Computer Operator q9LzwSSI
Junior Assistant-Cum-Computer Operator === Junior Assistant-cum-Computer Operator q9LzwSSI
Junior Assistant Cum Data Entry Operator === Junior Assistant-cum-Data Entry Operator q9LzwSSI
Junior Assistant cum Date Entry Operator === Junior Assistant-cum-Data Entry Operator q9LzwSSI
Junior Assistant cum Field Officer === Junior Assistant-cum-Field Officer q9LzwSSI
Junior Assistant cum Hindi Typist === Junior Assistant-cum-Hindi Typist q9LzwSSI
Junior Assistant â€“ II === Junior Assistant-II q9LzwSSI
Junior Assistant/ Junior Assistant Cum Caretaker === Junior Assistant/ Junior Assistant-cum-Caretaker q9LzwSSI
Jr. Boiler Operator === Junior Boiler Operator q9LzwSSI
junior Caliper Maker cum PO Technician Grade-III === Junior Caliper Maker-cum-PO Technician Grade-III q9LzwSSI
Junior Clerk Cum Compunder === Junior Clerk-cum-Compounder q9LzwSSI
Junior Clerk cum Typist === Junior Clerk-cum-Typist q9LzwSSI
Junior Clerk/ Account Clerk === Junior Clerk/ Accounts Clerk q9LzwSSI
Junior Coaches === Junior Coach q9LzwSSI
Junior Computer Programmer cum data Processor === Junior Computer Programmer-cum-data Processor q9LzwSSI
Jr.Draftsman === Junior Draftsman q9LzwSSI
Junior  Engineer === Junior Engineer q9LzwSSI
Junior Engineers === Junior Engineer q9LzwSSI
Jr.Engineer === Junior Engineer q9LzwSSI
Jr. Engineer === Junior Engineer q9LzwSSI
Jr. Engineer II (MEP) === Junior Engineer II (MEP) q9LzwSSI
Junior Engineer - C === Junior Engineer-C q9LzwSSI
Junior Engineer -II === Junior Engineer-II q9LzwSSI
Junior Enginer, HQ === Junior Engineer, HQ q9LzwSSI
Junior Engineering Assistant Grade II === Junior Engineering Assistant Grade-II q9LzwSSI
Junior Executives === Junior Executive q9LzwSSI
Jr. Faculty === Junior Faculty q9LzwSSI
Junior firemean === Junior fireman q9LzwSSI
Junior Flight Engineer (Sub- Inspector) === Junior Flight Engineer (Sub-Inspector) q9LzwSSI
Junior Flight Gunner (Sub- Inspector) === Junior Flight Gunner (Sub-Inspector) q9LzwSSI
Junior Hindi Assistant Gr.I === Junior Hindi Assistant Grade-I q9LzwSSI
Junior Hindi Tranlator === Junior Hindi Translator q9LzwSSI
Jr. Hindi Translator === Junior Hindi Translator q9LzwSSI
Junior Hindi Translator Cum Typist === Junior Hindi Translator-cum-Typist q9LzwSSI
Junior Hydro-geologist (Scientist B) === Junior Hydrogeologist (Scientist B) q9LzwSSI
Junior Intelligence Officer- I === Junior Intelligence Officer-I q9LzwSSI
Jr. Lab. Technician === Junior Lab. Technician q9LzwSSI
Junior Lagal Assistant === Junior Legal Assistant q9LzwSSI
Junior Library Assistant Grade II === Junior Library Assistant Grade-II q9LzwSSI
Junior Limb Maker cum PO Technician Grade-III === Junior Limb Maker-cum-PO Technician Grade-III q9LzwSSI
Junior Management Trainees === Junior Management Trainee q9LzwSSI
Jr. Manager === Junior Manager q9LzwSSI
Junior Managers === Junior Manager q9LzwSSI
Jr. Marketing === Junior Marketing q9LzwSSI
Junior Material Assistant - IV === Junior Material Assistant-IV q9LzwSSI
Jr. Nurse Gr.ll === Junior Nurse Grade-II q9LzwSSI
Junior Nursing Assistant- IV === Junior Nursing Assistant-IV q9LzwSSI
Junior Occupational Therapists === Junior Occupational Therapist q9LzwSSI
Junior Office Assistant cum Typist === Junior Office Assistant-cum-Typist q9LzwSSI
Junior Operator Grade I === Junior Operator Grade-I q9LzwSSI
Junior Operator Technician Cum Technical Assistant === Junior Operator Technician-cum-Technical Assistant q9LzwSSI
Junior Personal  Assistant === Junior Personal Assistant q9LzwSSI
Jr. Pharmacist Gr.ll === Junior Pharmacist Grade-II q9LzwSSI
Junior Pharmacovigilane Associate === Junior Pharmacovigilance Associate q9LzwSSI
Junior Physiotherapist /Occupational Therapists === Junior Physiotherapist /Occupational Therapist q9LzwSSI
Junior Proiect Assistant === Junior Project Assistant q9LzwSSI
Junior Project  Engineer === Junior Project Engineer q9LzwSSI
Junior Public Health Nurse Grade II === Junior Public Health Nurse Grade-II q9LzwSSI
Junior Purchase Assistant.Junior Storekeeper === Junior Purchase Assistant Junior Storekeeper q9LzwSSI
Junior Q C Inspector === Junior QC Inspector q9LzwSSI
Junior Radiotherapy Technicians === Junior Radiotherapy Technician q9LzwSSI
Junior Reseach Fellow === Junior Research Fellow q9LzwSSI
junior Research Felllow === Junior Research Fellow q9LzwSSI
Junior Reserach Fellow === Junior Research Fellow q9LzwSSI
Junior  Research Fellow === Junior Research Fellow q9LzwSSI
Junior Research Fellows === Junior Research Fellow q9LzwSSI
Junior Research Fellow (JRF) === Junior Research Fellow q9LzwSSI
Junior Research Fellows (JRF) === Junior Research Fellows q9LzwSSI
Junior Research Fellow JRF === Junior Research Fellow q9LzwSSI
Junior Research Fellow / Project Associate - I === Junior Research Fellow / Project Associate-I q9LzwSSI
Junior Research Fellowship === Junior Research Fellowhip q9LzwSSI
Junior Residents === Junior Resident q9LzwSSI
Junior Resident Doctors === Junior Resident Doctor q9LzwSSI
Junior Scale Stenographers === Junior Scale Stenographer q9LzwSSI
Junior Security Inspectors === Junior Security Inspector q9LzwSSI
Junior Ship Surveyor Cum Assistant Director General === Junior Ship Surveyor-cum-Assistant Director General q9LzwSSI
Junior Slinger Cum Rigger === Junior Slinger-cum-Rigger q9LzwSSI
Junior Specialists === Junior Specialist q9LzwSSI
Junior Steno Cum Data Entry Operator === Junior Steno-cum-Data Entry Operator q9LzwSSI
unior Stenographer === Junior Stenographer q9LzwSSI
Junior  Superintendent === Junior Superintendent q9LzwSSI
Junior Technical Assistant - IV === Junior Technical Assistant-IV q9LzwSSI
Jr.Technical Officer === Junior Technical Officer q9LzwSSI
Jr. Technician === Junior Technician q9LzwSSI
Jr. Technician Electrician === Junior Technician Electrician q9LzwSSI
Jr. Technician Fitter === Junior Technician Fitter q9LzwSSI
Jr. Technician Refrigerator === Junior Technician Refrigerator q9LzwSSI
Jr. Technician Welder === Junior Technician Welder q9LzwSSI
Junior Technician- Field Trials === Junior Technician-Field Trials q9LzwSSI
Junior Transiator === Junior Translator q9LzwSSI
Junior Typist Cum Junior Storekeeper === Junior Typist-cum-Junior Storekeeper q9LzwSSI
Junior Vocational Consultants === Junior Vocational Consultant q9LzwSSI
Jr. X-Ray === Junior X-ray q9LzwSSI
Junior X-Ray Assistant === Junior X-ray Assistant q9LzwSSI
Junior X-Ray Technician === Junior X-ray Technician q9LzwSSI
Jr Superintendent === JuniorSuperintendent q9LzwSSI
Jr Technical Superintendent === JuniorTechnical Superintendent q9LzwSSI
Kala-Azar Technical Suprervisor === Kala-Azar Technical Supervisor q9LzwSSI
Key Board Artist === Keyboard Artist q9LzwSSI
Key Board Player === Keyboard Player q9LzwSSI
Lab Asst === Lab  q9LzwSSI
Lab Analyst cum Sampler === Lab Analyst-cum-Sampler q9LzwSSI
Lab Assistant-Cum-Store Keeper === Lab Assistant-cum-Store Keeper q9LzwSSI
Lab Attendent === Lab Attendant q9LzwSSI
Lab Attendants Grade II === Lab Attendants Grade-II q9LzwSSI
Lab Attendant Grade II === Lab Attendant Grade-II q9LzwSSI
Lab Technician Gr-III === Lab Technician Grade-III q9LzwSSI
Lab Technician Gr-IV === Lab Technician Grade-IV q9LzwSSI
Lab Technician cum Data Entry Operator === Lab Technician-cum-Data Entry Operator q9LzwSSI
Lab Technician Cum Media Maker === Lab Technician-cum-Media Maker q9LzwSSI
Lab-Cum-Field Attendant === Lab-cum-Field Attendant q9LzwSSI
Lab cum Field Attendant === Lab-cum-Field Attendant q9LzwSSI
Lab cum field Workers === Lab-cum-field Workers q9LzwSSI
Lab cum Field Worker === Lab-cum-Field Worker q9LzwSSI
Lavoratory Assistant === Laboratory Assistant q9LzwSSI
Laboratory Assistants === Laboratory Assistant q9LzwSSI
Laboratory Assistant Grade II === Laboratory Assistant Grade-II q9LzwSSI
Laboratory Assistant Gr.III === Laboratory Assistant Grade-III q9LzwSSI
Laboratory Assistant cum Data Entry Operator === Laboratory Assistant-cum-Data Entry Operator q9LzwSSI
Laboratory Assistant-Cum-Storekeeper === Laboratory Assistant-cum-Storekeeper q9LzwSSI
Laboratory Attendant cum Peon === Laboratory Attendant-cum-Peon q9LzwSSI
Laboratory Technican === Laboratory Technician q9LzwSSI
Laboratory Technicians === Laboratory Technician q9LzwSSI
Laboratory Technician Grade II === Laboratory Technician Grade-II q9LzwSSI
Laboratory Technician- I === Laboratory Technician-I q9LzwSSI
Laboratory cum field Attendant === Laboratory-cum-field Attendant q9LzwSSI
Laboratory cum field Worker === Laboratory-cum-field Worker q9LzwSSI
Lady Medical Officer Gr-I === Lady Medical Officer Grade-I q9LzwSSI
Last Grade Servants === Last Grade Servant q9LzwSSI
Last Grade Employee === Last Grade-Employee q9LzwSSI
Law Clerks cum Legal Research Assistant === Law Clerks-cum-Legal Research Assistant q9LzwSSI
Law Clerk cum Legal Research Assistant === Law Clerk-cum-Legal Research Assistant q9LzwSSI
Law Clerk cum Research Associate === Law Clerk-cum-Research Associate q9LzwSSI
Law Officer Gr-I === Law Officer Grade-I q9LzwSSI
Law Officer Grade- II === Law Officer Grade-II q9LzwSSI
Law Officer Cum Junior Draftsman === Law Officer-cum-Junior Draftsman q9LzwSSI
Law Researchers === Law Researcher q9LzwSSI
Law cum Probation Officer === Law-cum-Probation Officer q9LzwSSI
Lay out Artist Cum Paster === Lay out Artist-cum-Paster q9LzwSSI
Lay Secretary and Treasurer Grade II === Lay Secretary and Treasurer Grade-II q9LzwSSI
LD Assistant cum Typist === LD Assistant-cum-Typist q9LzwSSI
LDCs === LDC q9LzwSSI
LDC Cum Librarian === LDC-cum-Librarian q9LzwSSI
Lead Structural Engineer cum Manager === Lead Structural Engineer-cum-Manager q9LzwSSI
Lecturers === Lecturer q9LzwSSI
Lecturers (Assistant Professors) === Lecturer (Assistant Professor) q9LzwSSI
Lecturer in Special Education - CP === Lecturer in Special Education-CP q9LzwSSI
Lecturer in Special Education - HI === Lecturer in Special Education-HI q9LzwSSI
Lecturer in Special Education - VI === Lecturer in Special Education-VI q9LzwSSI
Lecturer cum Instructor === Lecturer-cum-Instructor q9LzwSSI
Lecturer â€“I === Lecturer-I q9LzwSSI
Lecturer- III === Lecturer-III q9LzwSSI
Legal Adisor === Legal Advisor q9LzwSSI
Legal Advisor cum General Counsel === Legal Advisor-cum-General Counsel q9LzwSSI
Legal Aid Counsels === Legal Aid Counsel q9LzwSSI
Legal Associate cum Counsel === Legal Associate-cum-Counsel q9LzwSSI
Legal Consultants === Legal Consultant q9LzwSSI
Legal Dope Control Officers === Legal Dope Control Officer q9LzwSSI
Legal Experts === Legal Expert q9LzwSSI
Legal cum Probation Officer === Legal-cum-Probation Officer q9LzwSSI
Lekhpal cum Computer Operator === Lekhpal-cum-Computer Operator q9LzwSSI
Level -1 of VII CPC Pay Matrix === Level-1 of VII CPC Pay Matrix q9LzwSSI
Level -2 of VII CPC Pay Matrix === Level-2 of VII CPC Pay Matrix q9LzwSSI
Librarian and Information Assistant Grade II === Librarian and Information Assistant Grade-II q9LzwSSI
Librarian Gr-1 === Librarian Grade-1 q9LzwSSI
Librarian Grade I === Librarian Grade-I q9LzwSSI
Librarian Grade â€“ I === Librarian Grade-I q9LzwSSI
Librarian Gr-III === Librarian Grade-III q9LzwSSI
Librarian Grade III === Librarian Grade-III q9LzwSSI
Librarian Grade IV === Librarian Grade-IV q9LzwSSI
Librarian-Cum-Documentation Officer === Librarian-cum-Documentation Officer q9LzwSSI
Library Assistant/ Library Cum Documentation Assistant === Library Assistant/ Library-cum-Documentation Assistant q9LzwSSI
Library Attendant cum Typist === Library Attendant-cum-Typist q9LzwSSI
Library Clerks === Library Clerk q9LzwSSI
Library Professional Interns === Library Professional Intern q9LzwSSI
LIBRARY SUPERINTENDENT === LIBRARY SuperINTENDENT q9LzwSSI
Library Trainees === Library Trainee q9LzwSSI
Library cum Documentation Assistant === Library-cum-Documentation Assistant q9LzwSSI
Library cum Documentation Officer === Library-cum-Documentation Officer q9LzwSSI
Library cum Information Assistant === Library-cum-Information Assistant q9LzwSSI
Library cum Information Officer === Library-cum-Information Officer q9LzwSSI
Life Guard === Lifeguard q9LzwSSI
Life Guard Cum Instructor === Lifeguard-cum-Instructor q9LzwSSI
Lineman Grade I === Lineman Grade-I q9LzwSSI
Lineman Cum Fitter === Lineman-cum-Fitter q9LzwSSI
Liquid Wast Manager === Liquid Waste Manager q9LzwSSI
Live Stock Inspector Grade II === Live Stock Inspector Grade-II q9LzwSSI
Livestock Expansion Officer === Livestock Extension Officer q9LzwSSI
Lower Divison Assistant === Lower Division Assistant q9LzwSSI
Lower Division Assistant Cum- Computer Operator === Lower Division Assistant Cum-Computer Operator q9LzwSSI
Lowe Division Clerk === Lower Division Clerk q9LzwSSI
Lower Divison Clerk === Lower Division Clerk q9LzwSSI
Lower Division Cleark === Lower Division Clerk q9LzwSSI
Lower Division Clerks === Lower Division Clerk q9LzwSSI
Maintainace Officer === Maintenance Officer q9LzwSSI
Maintenance Supervisor cum Technical Assistant === Maintenance Supervisor-cum-Technical Assistant q9LzwSSI
Maire Tecnimont Postdoctoral Fellowship === Maire Tecnimont Postdoctoral Fellowhip q9LzwSSI
Maistries === Maistry q9LzwSSI
Make-up Artist === Makeup Artist q9LzwSSI
MANAGEMENT INDUSTIAL TRAINEE === Management Industrial Trainee q9LzwSSI
Manacgement Trainee === Management Trainee q9LzwSSI
Management Traine === Management Trainee q9LzwSSI
Management Trainees === Management Trainee q9LzwSSI
Management Trainee cum Counsellor === Management Trainee-cum-Counsellor q9LzwSSI
Manager (Works-Elect.) /Asstt. Engineer(Elect.) === Manager (Works-Elect.) /Assistant Engineer(Elect.) q9LzwSSI
Manager Grade II === Manager Grade-II q9LzwSSI
Manager (Grade-II) === Manager Grade-II q9LzwSSI
ManagerSenior Manager === Manager Senior Manager q9LzwSSI
Manager â€“ Law === Manager-Law q9LzwSSI
Manager(Works-Civil)/Asstt. Engineer(Civil) === Manager(Works-Civil)/Assistant Engineer(Civil) q9LzwSSI
manager/Assistant Manager/Jr. Manager === manager/Assistant Manager/Junior Manager q9LzwSSI
Manipur Judicial Service Grade lll === Manipur Judicial Service Grade-III q9LzwSSI
Marathi Language Officer cum Translator === Marathi Language Officer-cum-Translator q9LzwSSI
Marketing Executives === Marketing Executive q9LzwSSI
Marketing Executive Grade I === Marketing Executive Grade-I q9LzwSSI
Marketing Inspectors === Marketing Inspector q9LzwSSI
Mason Grade II === Mason Grade-II q9LzwSSI
Mason-Cum-Plumber === Mason-cum-Plumber q9LzwSSI
Masseurs === Masseur q9LzwSSI
Master Technicians === Master Technician q9LzwSSI
Maternal & Child Welfare Officer cum Lecture cum Assistant Professor === Maternal & Child Welfare Officer-cum-Lecture-cum-Assistant Professor q9LzwSSI
Maternity and Child Welfare Officer cum Assistant Professor === Maternity and Child Welfare Officer-cum-Assistant Professor q9LzwSSI
Maternity and Child Welfare Officer Cum Lecturer === Maternity and Child Welfare Officer-cum-Lecturer q9LzwSSI
Matric Recruits (MR) === Matric Recruit (MR) q9LzwSSI
Matron Care cum Hostel Incharge === Matron Care-cum-Hostel Incharge q9LzwSSI
Matron Grade I === Matron Grade-I q9LzwSSI
Matron Grade II === Matron Grade-II q9LzwSSI
Matron-Gr-II === Matron Grade-II q9LzwSSI
Matron cum Assistant Warden === Matron-cum-Assistant Warden q9LzwSSI
Matron-Cum-Storekeeper === Matron-cum-Storekeeper q9LzwSSI
MCO Gr-III === MCO Grade-III q9LzwSSI
MCWO cum Lecturer === MCWO-cum-Lecturer q9LzwSSI
MD Medicine/Physicians === MD Medicine/Physician q9LzwSSI
Mechanic Grade III === Mechanic Grade-III q9LzwSSI
Mechanic cum Mistri === Mechanic-cum-Mistri q9LzwSSI
Media Handler cum Typist === Media Handler-cum-Typist q9LzwSSI
Media Planner cum Liaison === Media Planner-cum-Liaison q9LzwSSI
Media Planner cum Liaison officer === Media Planner-cum-Liaison officer q9LzwSSI
Media-Designer-Cum-D === Media-Designer-cum-D q9LzwSSI
Medical and Health Officers === Medical and Health Officer q9LzwSSI
Medical Attendent === Medical Attendant q9LzwSSI
Medical Gas Pipe Line Technician === Medical Gas Pipeline Technician q9LzwSSI
Medical Lab Technician Grade - II === Medical Lab Technician Grade-II q9LzwSSI
Medical Labotary Technician Trainee === Medical Laboratory Technician Trainee q9LzwSSI
Medical Offcier === Medical Officer q9LzwSSI
Medical  Officer === Medical Officer q9LzwSSI
Medical Officers === Medical Officer q9LzwSSI
Medical Officers (Assistant Commandant) === Medical Officer (Assistant Commandant) q9LzwSSI
Medical Officer Gr-I === Medical Officer Grade-I q9LzwSSI
Medical Officer Health cum Lecturer === Medical Officer Health-cum-Lecturer q9LzwSSI
Medical Officer Orthopedics === Orthopedic q9LzwSSI
Medical Officer -E === Medical Officer-E q9LzwSSI
Medical Officer -SC === Medical Officer-SC q9LzwSSI
Medical Officer -SD === Medical Officer-SD q9LzwSSI
Medical Physicist cum Radiation Safety === Medical Physicist-cum-Radiation Safety q9LzwSSI
Medical Physicist cum Radiation Safety Officer === Medical Physicist-cum-Radiation Safety Officer q9LzwSSI
Medical Physicist cum RSO === Medical Physicist-cum-RSO q9LzwSSI
Medical Social Service Officer Grade- II === Medical Social Service Officer Grade-II q9LzwSSI
Medical Social Service Officer Grade II === Medical Social Service Officer Grade-II q9LzwSSI
Medical Specialists as Visiting Doctor === Medical Specialist as Visiting Doctor q9LzwSSI
MedicalSuperintendent === Medical Superintendent q9LzwSSI
Medical Transcriptionist cum Clinical Secretary === Medical Transcriptionist-cum-Clinical Secretary q9LzwSSI
Medical/Psychaitric Social Worker === Medical/Psychiatric Social Worker q9LzwSSI
Members === Member q9LzwSSI
Member Technical Staff - E-l (Scientist B) === Member Technical Staff-E-l (Scientist B) q9LzwSSI
Massenger === Messenger q9LzwSSI
Messiers === Messier q9LzwSSI
Meter Reader cum Pipe Fitter === Meter Reader-cum-Pipe Fitter q9LzwSSI
MHSA Co-ordinator === MHSA Coordinator q9LzwSSI
Micro Analyst cum Research Assistant === Micro Analyst-cum-Research Assistant q9LzwSSI
Micro Biologist === Microbiologist q9LzwSSI
Middle Level Consultants === Middle Level Consultant q9LzwSSI
Mid Wife === Midwife q9LzwSSI
Milk Recorder, Grade III === Milk Recorder, Grade-III q9LzwSSI
Mill Wright Mechanic Instructor === Millwright Mechanic Instructor q9LzwSSI
MIS cum Accountant === MIS-cum-Accountant q9LzwSSI
MIS cum GIS Expert === MIS-cum-GIS Expert q9LzwSSI
Mobiliser cum Placement Coordinator === Mobiliser-cum-Placement Coordinator q9LzwSSI
MPW cum Cleaner === MPW-cum-Cleaner q9LzwSSI
Mridangam Accompanists === Mridangam Accompanist q9LzwSSI
MSSO Gr-II === MSSO Grade-II q9LzwSSI
MTS cum Lab Attendant === MTS-cum-Lab Attendant q9LzwSSI
MTS - Library === MTS-Library q9LzwSSI
Multi - Purpose Staff === Multi-Purpose Staff q9LzwSSI
Multi Rehabilatation Worker === Multi Rehabilitation Worker q9LzwSSI
Multi Skill Assistant Gr-I === Multi Skill Assistant Grade-I q9LzwSSI
Multi Skilled Workder === Multi Skilled Worker q9LzwSSI
Multi tasking Assistance === Multitasking Assistance q9LzwSSI
Multi Tasking Assistant === Multitasking Assistant q9LzwSSI
Multi Tasking Attendant === Multitasking Attendant q9LzwSSI
Multi Tasking Officer === Multitasking Officer q9LzwSSI
Multi Tasking Staff === Multitasking Staff q9LzwSSI
Multi Tasking Staff (MTS) === Multitasking Staff (MTS) q9LzwSSI
Multi TaskingStaff (Peon) === Multitasking Staff (Peon) q9LzwSSI
Multi Tasking Staff Animal Attendant === Multitasking Staff Animal Attendant q9LzwSSI
Multi Tasking Staff Cook === Multitasking Staff Cook q9LzwSSI
Multi Tasking Staff Dresser === Multitasking Staff Dresser q9LzwSSI
Multi Tasking Staff Field Attendant === Multitasking Staff Field Attendant q9LzwSSI
Multi Tasking Staff Machine room Attendant === Multitasking Staff Machine room Attendant q9LzwSSI
Multi Tasking Staff Panchakarma Attendan === Multitasking Staff Panchkarma Attendan q9LzwSSI
Multi Tasking Staff Pharmacy Attendan === Multitasking Staff Pharmacy Attendan q9LzwSSI
Multi Tasking Staff Ward Aya === Multitasking Staff Ward Aya q9LzwSSI
Multi Tasking Staff Ward Boy === Multitasking Staff Ward Boy q9LzwSSI
Multi-tasking Assistant === Multitasking Assistant q9LzwSSI
Multi-Tasking Attendant === Multitasking Attendant q9LzwSSI
Multi-Tasking Executive === Multitasking Executive q9LzwSSI
Multi-Tasking Officer === Multitasking Officer q9LzwSSI
Multi -Tasking Staff === Multitasking Staff q9LzwSSI
4. Multi- tasking Staff === Multitasking Staff q9LzwSSI
Multi-Tasking Staff === Multitasking Staff q9LzwSSI
Multi-Tasking Staff (Gunman) === Multitasking Staff (Gunman) q9LzwSSI
Multi-Tasking Staff Library (Library Attendant) === Multitasking Staff Library (Library Attendant) q9LzwSSI
Multi-Tasking Staff(Gunman) === Multitasking Staff(Gunman) q9LzwSSI
Multi-Tasking Technical Assistant === Multitasking Technical Assistant q9LzwSSI
Multi-Tasking-Staff === Multitasking-Staff q9LzwSSI
Multi-Tasking-Staff-I === Multitasking-Staff-I q9LzwSSI
Multi Media Content Creator === Multimedia Content Creator q9LzwSSI
Multimedia Designer cum Video editor === Multimedia Designer-cum-Video editor q9LzwSSI
Multipurpose Workers === Multipurpose Worker q9LzwSSI
Municipal Commissioner  Grade-II === Municipal Commissioner Grade-II q9LzwSSI
Municipal Commissioner Grade III === Municipal Commissioner Grade-III q9LzwSSI
Museum cum Animal Keeper === Museum-cum-Animal Keeper q9LzwSSI
Narration Artists === Narration Artist q9LzwSSI
Nava Kerala Post Doctoral Fellowship === Nava Kerala Post Doctoral Fellowhip q9LzwSSI
Navigational Assistant Grade -III === Navigational Assistant Grade-III q9LzwSSI
Navigational Assistant Grade- iii === Navigational Assistant Grade-iii q9LzwSSI
Near Costal Voyage Trainee === Near Coastal Voyage Trainee q9LzwSSI
Network Administrators === Network Administrator q9LzwSSI
Network & Security Administrators === Network & Security Administrator q9LzwSSI
Network Specialists === Network Specialist q9LzwSSI
News Reader === Anesthesiologist q9LzwSSI
Newsreader cum Translator === Newsreader-cum-Translator q9LzwSSI
Newsreader-cum- Translator === Newsreader-cum-Translator q9LzwSSI
Nodal Study Centre In- Charge === Nodal Study Centre In-Charge q9LzwSSI
Non-Technical Apprentices === Non-Technical Apprentice q9LzwSSI
Non- Vocational Teacher === Non-Vocational Teacher q9LzwSSI
Nurses === Nurse q9LzwSSI
Nurse Grade â€“ A === Nurse Grade-A q9LzwSSI
Nurse Grade I === Nurse Grade-I q9LzwSSI
Nurse Grade -I === Nurse Grade-I q9LzwSSI
Nurse Grade II === Nurse Grade-II q9LzwSSI
Nurse Grade -II === Nurse Grade-II q9LzwSSI
Nurse â€“A === Nurse-A q9LzwSSI
Nursing Assistant Grade I === Nursing Assistant Grade-I q9LzwSSI
Nursing  Superintendent === Nursing Superintendent q9LzwSSI
Nursing Superintendent Grade I === Nursing Superintendent Grade-I q9LzwSSI
Nursing Superintendent Grade II === Nursing Superintendent Grade-II q9LzwSSI
Nutritional Counsellors === Nutritional Counsellor q9LzwSSI
Occupational Therapist cum Physiotherapist === Occupational Therapist-cum-Physiotherapist q9LzwSSI
Office Assitant === Office Assistant q9LzwSSI
Office Assistant Grade I === Office Assistant Grade-I q9LzwSSI
Office Assistant Grade III === Office Assistant Grade-III q9LzwSSI
Office Assistant cum Accountant === Office Assistant-cum-Accountant q9LzwSSI
Office Assistant-cum- Data Entry Operator === Office Assistant-cum-Data Entry Operator q9LzwSSI
Office Assistant - II === Office Assistant-II q9LzwSSI
Office Assistant -III === Office Assistant-III q9LzwSSI
Office Attendent === Office Attendant q9LzwSSI
Office Attendant cum Driver === Office Attendant-cum-Driver q9LzwSSI
Office Attender Grade II === Office Attender Grade-II q9LzwSSI
Office Bearers === Office Bearer q9LzwSSI
Office Executive cum Assistant === Office Executive-cum-Assistant q9LzwSSI
Office Manager Cum Accountant === Office Manager-cum-Accountant q9LzwSSI
Office Superintendent cum Accountant === Office Superintendent-cum-Accountant q9LzwSSI
Office cum Account Assistant-Block === Office-cum-Accounts Assistant-Block q9LzwSSI
Officers === Officer q9LzwSSI
Officer Grade A === Officer Grade-A q9LzwSSI
Officer Grade B === Officer Grade-B q9LzwSSI
Officer Grade II === Officer Grade-II q9LzwSSI
Officer (Grade-III) === Officer Grade-III q9LzwSSI
Officers on Contract - IT === Officers on Contract-IT q9LzwSSI
Officer on Special Duy (Civil) === Officer on Special Duty (Civil) q9LzwSSI
Officer Superintendents === Officer Superintendent q9LzwSSI
Officers Training Academy (Men) === Officer Training Academy (Men) q9LzwSSI
Officers Training Academy (Women) === Officer Training Academy (Women) q9LzwSSI
Officer - Company Secretary === Officer-Company Secretary q9LzwSSI
On-boarding Executive === Onboarding Executive q9LzwSSI
Operator Gr.I === Operator Grade-I q9LzwSSI
Operator Gr.II === Operator Grade-II q9LzwSSI
Operator Gr.III === Operator Grade-III q9LzwSSI
Operator-Cum-Mechanic === Operator-cum-Mechanic q9LzwSSI
Operator Cum Technician === Operator-cum-Technician q9LzwSSI
Operator cum Technician Trainee === Operator-cum-Technician Trainee q9LzwSSI
Operator- Hydraulic Press for Ballistic Panel Moulding === Operator-Hydraulic Press for Ballistic Panel Moulding q9LzwSSI
Opthalmic Assistant === Ophthalmic Assistant q9LzwSSI
Opthalmic Technician === Ophthalmic Technician q9LzwSSI
Ophthalmic Technician Grade I === Ophthalmic Technician Grade-I q9LzwSSI
Opthalmologist === Ophthalmologist q9LzwSSI
Optical Sales Assistant cum Cashier === Optical Sales Assistant-cum-Cashier q9LzwSSI
Optional Trade Apprentices === Optional Trade Apprentice q9LzwSSI
Optometrist Gr.II === Optometrist Grade-II q9LzwSSI
Ordinary Grade Driver === Ordinary Grade-Driver q9LzwSSI
Orientation and Mobility Instructor cum Special Educator-VI === Orientation and Mobility Instructor-cum-Special Educator-VI q9LzwSSI
Orthopaedic === Orthopaedics q9LzwSSI
Orthtotist === Orthotist q9LzwSSI
Out Reach Worker === Outreach Worker q9LzwSSI
Overseer Gr -I === Overseer Grade-I q9LzwSSI
Overseer Grade I === Overseer Grade-I q9LzwSSI
Overseer Grade II === Overseer Grade-II q9LzwSSI
Overseer cum Sanitary Inspector === Overseer-cum-Sanitary Inspector q9LzwSSI
Painter Grade II === Painter Grade-II q9LzwSSI
Painter-Cum- Artist === Painter-cum-Artist q9LzwSSI
Painter-Cum-Artist === Painter-cum-Artist q9LzwSSI
Panchakarma === Panchkarma q9LzwSSI
Panchakarma Assistant === Panchkarma Assistant q9LzwSSI
Panchakarma Attendant === Panchkarma Attendant q9LzwSSI
Panchakarma Nurse === Panchkarma Nurse q9LzwSSI
Panchakarma Technician === Panchkarma Technician q9LzwSSI
Panchakarma Therapist === Panchkarma Therapist q9LzwSSI
Panchakarma Therapists === Panchkarma Therapists q9LzwSSI
Pachkarma Therapist === Panchkarma Therapist q9LzwSSI
Panchakaram Vaidya === Panchkarma Vaidya q9LzwSSI
Panchakarma Vaidya === Panchkarma Vaidya q9LzwSSI
Pannel Doctor === Panel Doctor q9LzwSSI
Para Professional Social Worker === Paraprofessional Social Worker q9LzwSSI
Part Time Lecturers === Part Time Lecturer q9LzwSSI
Part Time Sports Coaches === Part Time Sports Coach q9LzwSSI
Part Time teacher === Part Time Teacher q9LzwSSI
Patient care Manager cum Admin Executive === Patient care Manager-cum-Admin Executive q9LzwSSI
PEM cum Matron === PEM-cum-Matron q9LzwSSI
PEM/PTI-Cum-Matron === PEM/PTI-cum-Matron q9LzwSSI
PEM/PTI Cum Matron === PEM/PTI-cum-Matron q9LzwSSI
PEM/PTI-Cum-Matron (Female) === PEM/PTI-cum-Matron (Female) q9LzwSSI
Peons === Peon q9LzwSSI
Peons (Male/female) === Peon (Male/female) q9LzwSSI
Peon cum Driver === Peon-cum-Driver q9LzwSSI
Peon-Cum-Packer === Peon-cum-Packer q9LzwSSI
Perfusionist Grade II === Perfusionist Grade-II q9LzwSSI
Personal and General Assistant Grade I === Personal and General Assistant Grade-I q9LzwSSI
Personal & General Assistant Grade I, II and III === Personal & General Assistant Grade-I, II and III q9LzwSSI
Personal and General Assistant Grade II === Personal and General Assistant Grade-II q9LzwSSI
Personal and General Assistant Grade III === Personal and General Assistant Grade-III q9LzwSSI
Personal Assistan === Personal Assistant q9LzwSSI
Personnal Assistant === Personal Assistant q9LzwSSI
Personal  Assistant === Personal Assistant q9LzwSSI
Pesonal Assistant to Registrar === Personal Assistant to Registrar q9LzwSSI
Personal Assistant Cum Clerk === Personal Assistant-cum-Clerk q9LzwSSI
Personal Assistant cum Confidential Assistant === Personal Assistant-cum-Confidential Assistant q9LzwSSI
Personal Assistant/Stenographer Grade C === Personal Assistant/Stenographer Grade-C q9LzwSSI
Personal Clerk to  General Manager === Personal Clerk to General Manager q9LzwSSI
Personal Executives === Personal Executive q9LzwSSI
Personal Secretriate === Personal Secretary q9LzwSSI
Personel Secretary === Personal Secretary q9LzwSSI
Personal Secretory to Chairman === Personal Secretary to Chairman q9LzwSSI
Personel Secretary to Principle Director === Personal Secretary to Principal Director q9LzwSSI
Personal Secretary cum Stenographer === Personal Secretary-cum-Stenographer q9LzwSSI
PFMS Experts === PFMS Expert q9LzwSSI
PGT Biology - Female === PGT Biology-Female q9LzwSSI
PGT Biology - Male === PGT Biology-Male q9LzwSSI
PGT Chemistry -Female === PGT Chemistry-Female q9LzwSSI
PGT Chemistry - Male === PGT Chemistry-Male q9LzwSSI
PGT Commerce- Female === PGT Commerce-Female q9LzwSSI
PGT Commerce- Male === PGT Commerce-Male q9LzwSSI
PGT English - Female === PGT English-Female q9LzwSSI
PGT English - Male === PGT English-Male q9LzwSSI
PGT Geography- Male === PGT Geography-Male q9LzwSSI
PGT History - Male === PGT History-Male q9LzwSSI
PGT Maths - Female === PGT Maths-Female q9LzwSSI
PGT Maths - Male === PGT Maths-Male q9LzwSSI
PGT Physics - Female === PGT Physics-Female q9LzwSSI
PGT Physics - Male === PGT Physics-Male q9LzwSSI
PGT Punjabi - Female === PGT Punjabi-Female q9LzwSSI
PGT Sanskrit - Female === PGT Sanskrit-Female q9LzwSSI
Pharmasist === Pharmacist q9LzwSSI
Pharmacists === Pharmacist q9LzwSSI
Pharmacist Grade I === Pharmacist Grade-I q9LzwSSI
Pharmacist Gr-II === Pharmacist Grade-II q9LzwSSI
Pharmacist Grade II === Pharmacist Grade-II q9LzwSSI
Pharmacist Grade III === Pharmacist Grade-III q9LzwSSI
Pharmacist Cum Clerk === Pharmacist-cum-Clerk q9LzwSSI
Pharmacist cum Dresser === Pharmacist-cum-Dresser q9LzwSSI
Pharmacist Cum Office Assistant === Pharmacist-cum-Office Assistant q9LzwSSI
PhD Fellowship === PhD Fellowhip q9LzwSSI
Photographer cum Video Editor === Photographer-cum-Video Editor q9LzwSSI
Photostate Operator === Photostat Operator q9LzwSSI
Photostat-Cum- Equipment Operator === Photostat-cum-Equipment Operator q9LzwSSI
Physical Efficiency Master cum Matron === Physical Efficiency Master-cum-Matron q9LzwSSI
Physical Training Instructor-Cum-Matron === Physical Training Instructor-cum-Matron q9LzwSSI
Physical Training Instructor Cum Matron === Physical Training Instructor-cum-Matron q9LzwSSI
Physical Training cum Yoga Instructor === Physical Training-cum-Yoga Instructor q9LzwSSI
Physicist cum Radiation Safety Officer === Physicist-cum-Radiation Safety Officer q9LzwSSI
Physio Therapist === Physiotherapist q9LzwSSI
Physiorherapist === Physiotherapist q9LzwSSI
Physiotherapist Grade I === Physiotherapist Grade-I q9LzwSSI
Physiotherapist Grade III === Physiotherapist Grade-III q9LzwSSI
Pilot Officers === Pilot Officer q9LzwSSI
Placement Officer cum Coordinator === Placement Officer-cum-Coordinator q9LzwSSI
Placement Cum Communication Officer === Placement-cum-Communication Officer q9LzwSSI
Plantation Watchers === Plantation Watcher q9LzwSSI
Plumber cum Pump Operator === Plumber-cum-Pump Operator q9LzwSSI
Post Doctoral Fellows === Post Doctoral Fellow q9LzwSSI
Post Doctoral Fellowship === Post Doctoral Fellowhip q9LzwSSI
Post Graduate Teachers === Post Graduate Teacher q9LzwSSI
Post Graduate Teachers (PGT) === Post Graduate Teacher (PGT) q9LzwSSI
Post-Doctoral Associate === Postdoctoral Associate q9LzwSSI
Post-Doctoral Fellow === Postdoctoral Fellow q9LzwSSI
Post-Doctoral Fellows === Postdoctoral Fellow q9LzwSSI
Post-Doctoral Fellowship === Postdoctoral Fellowhip q9LzwSSI
Post-Doctoral Project Scientist-I === Postdoctoral Project Scientist-I q9LzwSSI
Post-Doctoral Project Scientist-II === Postdoctoral Project Scientist-II q9LzwSSI
Post-Doctoral Project Scientist-III === Postdoctoral Project Scientist-III q9LzwSSI
Post-Doctoral Research === Postdoctoral Research q9LzwSSI
Post-Doctoral Research Associate === Postdoctoral Research Associate q9LzwSSI
Post-Doctoral Research Fellow === Postdoctoral Research Fellow q9LzwSSI
Post-doctoral researcher === Postdoctoral researcher q9LzwSSI
Post-graduate teachers === Post-graduate Teachers q9LzwSSI
Post-Graduate Teachers (PGT) === Post-Graduate Teacher (PGT) q9LzwSSI
Postdoctoral Fellowship === Postdoctoral Fellowhip q9LzwSSI
Post Doctoral Research Associate === Postdoctoral Research Associate q9LzwSSI
Post Doctoral Research Fellow === Postdoctoral Research Fellow q9LzwSSI
PPM Cordinator === PPM Coordinator q9LzwSSI
PPP Expert - Public Transport === PPP Expert-Public Transport q9LzwSSI
Preservation Assistant-Cum-Garden Overseer === Preservation Assistant-cum-Garden Overseer q9LzwSSI
Primary Teachers === Primary Teacher q9LzwSSI
Principals === Principal q9LzwSSI
Principal Chief Consultants === Principal Chief Consultant q9LzwSSI
Principle Investment Officer === Principal Investment Officer q9LzwSSI
Principal Officer cum Joint Director General === Principal Officer-cum-Joint Director General q9LzwSSI
Principal Private Secretaries === Principal Private Secretary q9LzwSSI
Pricipal Private Secretary === Principal Private Secretary q9LzwSSI
Principle Private Secretary === Principal Private Secretary q9LzwSSI
Principal Project Associate cum Senior Copy Editor === Principal Project Associate-cum-Senior Copy Editor q9LzwSSI
Principle Scientific Officer === Principal Scientific Officer q9LzwSSI
Principle Scientist === Principal Scientist q9LzwSSI
Principal Cum Associate Dean === Principal-cum-Associate Dean q9LzwSSI
Principal cum Professor === Principal-cum-Professor q9LzwSSI
Printer cum Record Keeper === Printer-cum-Record Keeper q9LzwSSI
Private Secretaries === Private Secretary q9LzwSSI
Private Secretary Gr-II === Private Secretary Grade-II q9LzwSSI
Private Secretary Gr-III === Private Secretary Grade-III q9LzwSSI
Probationary Account Officer === Probationary Accounts Officer q9LzwSSI
Probationary Officers === Probationary Officer q9LzwSSI
Processing Worker Gr.lll === Processing Worker Grade-III q9LzwSSI
Processing-Cum-Quality Assurance Supervisor === Processing-cum-Quality Assurance Supervisor q9LzwSSI
Procurement  Specialist === Procurement Specialist q9LzwSSI
Product Cum Project Manager === Product-cum-Project Manager q9LzwSSI
Professionals === Professional q9LzwSSI
Professional Engineering Manager Cum Matron === Professional Engineering Manager-cum-Matron q9LzwSSI
Professionals Legal === Professional Legal q9LzwSSI
Professors === Professor q9LzwSSI
Professor Hospital Administration Cum Medical Superintendent === Professor Hospital Administration-cum-Medical Superintendent q9LzwSSI
Professor -cum-Director === Professor-cum-Director q9LzwSSI
Professor cum Director === Professor-cum-Director q9LzwSSI
Professor cum Principal === Professor-cum-Principal q9LzwSSI
Professor Cum Vice Principal === Professor-cum-Vice Principal q9LzwSSI
Professor cum Vice - Principal === Professor-cum-Vice-Principal q9LzwSSI
Professor cum Vice-Principal === Professor-cum-Vice-Principal q9LzwSSI
Professor/Principle === Professor/Principal q9LzwSSI
Program Assistant cum Field Officer === Program Assistant-cum-Field Officer q9LzwSSI
Program Assistant- II === Program Assistant-II q9LzwSSI
Program Associates === Program Associate q9LzwSSI
Program Manager -I === Program Manager-I q9LzwSSI
Program Officers === Program Officer q9LzwSSI
Programme and  Public Relation Officer === Programme and Public Relation Officer q9LzwSSI
PROGRMME ASSISTANT === PROGRAMME ASSISTANT q9LzwSSI
Progamme Assistant === Programme Assistant q9LzwSSI
Programme Assistan === Programme Assistant q9LzwSSI
Programme Assistant cum Data Entry Operator === Programme Assistant-cum-Data Entry Operator q9LzwSSI
Programme Support Executives === Programme Support Executive q9LzwSSI
Programme Cum Script Writer === Programme-cum-Script Writer q9LzwSSI
Programmers === Programmer q9LzwSSI
Programmer Asstt. === Programmer Assistant q9LzwSSI
Programmer Grade- II === Programmer Grade-II q9LzwSSI
Programmer Cum Operator === Programmer-cum-Operator q9LzwSSI
Programmer cum Systems Analyst === Programmer-cum-Systems Analyst q9LzwSSI
Programmer Cum Technical Officer === Programmer-cum-Technical Officer q9LzwSSI
Project Assisant === Project Assistant q9LzwSSI
Project Assiatant === Project Assistant q9LzwSSI
Project assistan === Project assistant q9LzwSSI
Project Assistants === Project Assistant q9LzwSSI
Project Assistant Grade I === Project Assistant Grade-I q9LzwSSI
Project Assistant Grade II === Project Assistant Grade-II q9LzwSSI
Project Assistant - 1 === Project Assistant-1 q9LzwSSI
Project Assistant cum Analyst === Project Assistant-cum-Analyst q9LzwSSI
Project Assistant - I === Project Assistant-I q9LzwSSI
Project Assistant â€“ I === Project Assistant-I q9LzwSSI
Project Assistant â€“ III === Project Assistant-III q9LzwSSI
Project Assistants(L1) === Project Assistant(L1) q9LzwSSI
Project Assistants(L2) === Project Assistant(L2) q9LzwSSI
Proiect Associate === Project Associate q9LzwSSI
Project Assosiate === Project Associate q9LzwSSI
Project Associates === Project Associate q9LzwSSI
Project Associate Level - I === Project Associate Level-I q9LzwSSI
Project associate-1 === Project Associate-1 q9LzwSSI
Project  Associate- I === Project Associate-I q9LzwSSI
Project  Associate-i === Project Associate-i q9LzwSSI
Project Associateâ€“I === Project Associate-I q9LzwSSI
Project Assoicate-I === Project Associate-I q9LzwSSI
Project Associate- I === Project Associate-I q9LzwSSI
Project Associate â€“ I === Project Associate-I q9LzwSSI
Project Associate -I === Project Associate-I q9LzwSSI
Project Associate - I === Project Associate-I q9LzwSSI
Project Associate- II === Project Associate-II q9LzwSSI
Project Associateâ€“II === Project Associate-II q9LzwSSI
Project Associate â€“ II === Project Associate-II q9LzwSSI
Project Associate - II === Project Associate-II q9LzwSSI
Project Associate -II === Project Associate-II q9LzwSSI
Project Coordinators === Project Coordinator q9LzwSSI
Project Co-ordinator === Project Coordinator q9LzwSSI
Project Coodinator === Project Coordinator q9LzwSSI
Project Co-ordinator cum Research Officer === Project Coordinator-cum-Research Officer q9LzwSSI
Project Data Entry Operator Grade A === Project Data Entry Operator Grade-A q9LzwSSI
Project Data Entry Operator Grade B === Project Data Entry Operator Grade-B q9LzwSSI
Project Driver cum Mechanic === Project Driver-cum-Mechanic q9LzwSSI
project enginner === project engineer q9LzwSSI
Project Engineers === Project Engineer q9LzwSSI
Project Engineer cum Estate Officer === Project Engineer-cum-Estate Officer q9LzwSSI
Project Engineer -I === Project Engineer-I q9LzwSSI
Project Engineer- I === Project Engineer-I q9LzwSSI
Project Fellow Grade I === Project Fellow Grade-I q9LzwSSI
Project Fellow cum Data Entry Operator === Project Fellow-cum-Data Entry Operator q9LzwSSI
Project Fellow -I === Project Fellow-I q9LzwSSI
Project Interns === Project Intern q9LzwSSI
Project JRF === Project Junior Research Fellow q9LzwSSI
Project Laboratory Assistant (B) [Electronics wiring & assembly] === Project Laboratory Assistant (B) (Electronics wiring & assembly) q9LzwSSI
Project Manager cum Senior Consultant === Project Manager-cum-Senior Consultant q9LzwSSI
Project Manager Cum Senior Software Developer === Project Manager-cum-Senior Software Developer q9LzwSSI
Project Manager cum Senior Software Engineer === Project Manager-cum-Senior Software Engineer q9LzwSSI
Project Manager cum Water Resource Expert === Project Manager-cum-Water Resource Expert q9LzwSSI
Project Multi Tasking Staff === Project Multitasking Staff q9LzwSSI
Project Multi-Tasking Staff === Project Multitasking Staff q9LzwSSI
Project Nurseâ€“II === Project Nurse-II q9LzwSSI
Project Nurse- III === Project Nurse-III q9LzwSSI
Project Nurse -III === Project Nurse-III q9LzwSSI
Project Officers === Project Officer q9LzwSSI
Project Research Associate - III === Project Research Associate-III q9LzwSSI
Project Research Scientists-I === Project Research Scientist-I q9LzwSSI
Project Research Scientist- I === Project Research Scientist-I q9LzwSSI
Project Research Scientist â€“ I === Project Research Scientist-I q9LzwSSI
Project Research Scientistâ€“I === Project Research Scientist-I q9LzwSSI
Project Research Scientist -I === Project Research Scientist-I q9LzwSSI
Project Research Scientist-Il === Project Research Scientist-II q9LzwSSI
Project Research Scientist- II === Project Research Scientist-II q9LzwSSI
Project Research Scientist -II === Project Research Scientist-II q9LzwSSI
Project Research Scientist â€“ II === Project Research Scientist-II q9LzwSSI
Project Research Scientistâ€“II === Project Research Scientist-II q9LzwSSI
Project Scientific Assistant (B) [Civil] === Project Scientific Assistant (B) (Civil) q9LzwSSI
Project Scientific Officer (B) [Detector] === Project Scientific Officer (B) (Detector) q9LzwSSI
Project Scientific Officer (C) [Electronics] === Project Scientific Officer (C) (Electronics) q9LzwSSI
Project Scientific Officer- B === Project Scientific Officer-B q9LzwSSI
Project Scientists II === Project Scientist II q9LzwSSI
Project Scientistâ€“B === Project Scientist-B q9LzwSSI
Project Scientist â€“ B === Project Scientist-B q9LzwSSI
Project Scientist - B === Project Scientist-B q9LzwSSI
Project Scientistâ€“C === Project Scientist-C q9LzwSSI
Project Scientist - C === Project Scientist-C q9LzwSSI
Project Scientist - D === Project Scientist-D q9LzwSSI
Proiect Scientist-I === Project Scientist-I q9LzwSSI
Project Scientist -I === Project Scientist-I q9LzwSSI
Project Scientist - I === Project Scientist-I q9LzwSSI
Project Scientistâ€“I === Project Scientist-I q9LzwSSI
Project Scientist â€“ I === Project Scientist-I q9LzwSSI
Project Scientist- II === Project Scientist-II q9LzwSSI
eSawa Kendra Office Assistant === Project Scientist-II q9LzwSSI
Project Scientistâ€“II === Project Scientist-II q9LzwSSI
Project Scientist - II === Project Scientist-II q9LzwSSI
Project Scientistâ€“III === Project Scientist-III q9LzwSSI
Project Scientist -III === Project Scientist-III q9LzwSSI
Project Scientist- ll === Project Scientist-ll q9LzwSSI
Project Senior Tecnical Assistant === Project Senior Technical Assistant q9LzwSSI
Project Site Enginners === Project Site Engineers q9LzwSSI
Project Technical  Officer === Project Technical Officer q9LzwSSI
Project Technical officer Cum field Worker === Project Technical officer-cum-field Worker q9LzwSSI
Project Technical Support- I === Project Technical Support-I q9LzwSSI
Project Technical Support-Il === Project Technical Support-II q9LzwSSI
Project Technical Supportâ€“II === Project Technical Support-II q9LzwSSI
Project Technical Support- II === Project Technical Support-II q9LzwSSI
Project Technical Support â€“ III === Project Technical Support-III q9LzwSSI
Project Technical Supportâ€“III === Project Technical Support-III q9LzwSSI
Project Technical Support -III === Project Technical Support-III q9LzwSSI
Project Technical Support- III === Project Technical Support-III q9LzwSSI
Project Technician Grade I === Project Technician Grade-I q9LzwSSI
Project Technician Grade III === Project Technician Grade-III q9LzwSSI
Project Technician Suport- III === Project Technician Support-III q9LzwSSI
Project Technician- III === Project Technician-III q9LzwSSI
Project Theme Coodinator === Project Theme Coordinator q9LzwSSI
Project Tradesman- B === Project Tradesman-B q9LzwSSI
Proof Reader === Proofreader q9LzwSSI
Proof Reader cum General Assistant === Proofreader-cum-General Assistant q9LzwSSI
Prosthotist & Orthotist === Prosthetist & Orthotist q9LzwSSI
Prosthetise and Orthotise === Prosthetist and Orthotist q9LzwSSI
Prosthetist cum Orthotist === Prosthetist-cum-Orthotist q9LzwSSI
Proto-typing Technician === Prototyping Technician q9LzwSSI
Psychriatric === Psychiatric q9LzwSSI
Psychological Councillor === Psychological Counsellor q9LzwSSI
Psychologis === Psychologist q9LzwSSI
Psychologist cum counsellor === Psychologist-cum-counsellor q9LzwSSI
PT Instructor cum Yoga Trainer === PT Instructor-cum-Yoga Trainer q9LzwSSI
PTI cum Matron === PTI-cum-Matron q9LzwSSI
PTI-Cum-Matron Female === PTI-cum-Matron Female q9LzwSSI
PTI/PEM cum Matron === PTI/PEM-cum-Matron q9LzwSSI
Public Financial Management System Experts//Consultants === Public Financial Management System Expert//Consultant q9LzwSSI
Public Policy Analyst/(Consultant Grade I) === Public Policy Analyst/(Consultant Grade-I) q9LzwSSI
Public Policy Specialist-(Consultant Grade II) === Public Policy Specialist-(Consultant Grade-II) q9LzwSSI
Public Prosecutors === Public Prosecutor q9LzwSSI
Public Relation Officer cum Publication officer === Public Relation Officer-cum-Publication officer q9LzwSSI
Public Relations Associate cum Executive Assistant === Public Relations Associate-cum-Executive Assistant q9LzwSSI
Publication Assistant cum Proof Reader === Publication Assistant-cum-Proofreader q9LzwSSI
Publishing Asistant === Publishing Assistant q9LzwSSI
Pump Operator Cum Mechanic === Pump Operator-cum-Mechanic q9LzwSSI
Punjab superior Judicial service === Punjab Superior Judicial service q9LzwSSI
Q.C. Assistant cum Technical Assistant (Mechanical) === Q.C. Assistant-cum-Technical Assistant (Mechanical) q9LzwSSI
QCA Gr-III === QCA Grade-III q9LzwSSI
Quality Assurance Engineers === Quality Assurance Engineer q9LzwSSI
Quality Coordinator Cum Internal Auditor === Quality Coordinator-cum-Internal Auditor q9LzwSSI
Quarter Master === Quartermaster q9LzwSSI
Radio Operators === Radio Operator q9LzwSSI
Radio Grapher === Radiographer q9LzwSSI
Radiological Saftey Officer === Radiological Safety Officer q9LzwSSI
Radio Therapy Technician === Radiotherapy Technician q9LzwSSI
Radio Therapy Technician Grade-II === Radiotherapy Technician Grade-II q9LzwSSI
Radio-therapy Technician Grade-II === Radiotherapy Technician Grade-II q9LzwSSI
Radio-Therapy Technologist === Radiotherapy Technologist q9LzwSSI
Rail Cum Road Vehicle === Rail-cum-Road Vehicle q9LzwSSI
Rail Cum Road Vehicle Operators === Rail-cum-Road Vehicle Operators q9LzwSSI
Raja Jwala Prasad Post-Doctoral Fellow === Raja Jwala Prasad Postdoctoral Fellow q9LzwSSI
Ramanujan Fellowship === Ramanujan Fellowhip q9LzwSSI
Reader Dravya Guna === Reader Dravyaguna q9LzwSSI
Receiptionist === Receptionist q9LzwSSI
Receptionists === Receptionist q9LzwSSI
Receptionist Cum Clerk === Receptionist-cum-Clerk q9LzwSSI
Receptionist cum Office Assistant === Receptionist-cum-Office Assistant q9LzwSSI
Receptionist cum Telephone Operator === Receptionist-cum-Telephone Operator q9LzwSSI
Receptionist-Cum-Ticketing Assistant === Receptionist-cum-Ticketing Assistant q9LzwSSI
Record Keepar === Record Keeper q9LzwSSI
Regional Establishment Officer (Grade-I) === Regional Establishment Officer Grade-I q9LzwSSI
Regional Establishment Officer (Grade-II) === Regional Establishment Officer Grade-II q9LzwSSI
Registration Clerk Cum Storekeeper === Registration Clerk-cum-Storekeeper q9LzwSSI
REO (Grade I) === REO Grade-I q9LzwSSI
Reporter Grade II === Reporter Grade-II q9LzwSSI
Reproductive Maternal, Newborn and Child health  Family Planning  Counsellor === Reproductive Maternal, Newborn and Child health Family Planning Counsellor q9LzwSSI
Research Analysts === Research Analyst q9LzwSSI
Research & Literary Curators === Research & Literary Curator q9LzwSSI
Research Assistants === Research Assistant q9LzwSSI
Research Assistant cum Analyst === Research Assistant-cum-Analyst q9LzwSSI
Research Assistant cum Field Investigator === Research Assistant-cum-Field Investigator q9LzwSSI
Research Assistant cum Field Surveyor === Research Assistant-cum-Field Surveyor q9LzwSSI
Research Asociate === Research Associate q9LzwSSI
Research Associates === Research Associate q9LzwSSI
Research Associate  I === Research Associate I q9LzwSSI
Research Associateâ€“I === Research Associate-I q9LzwSSI
Research Associate - I === Research Associate-I q9LzwSSI
Research Associate -I === Research Associate-I q9LzwSSI
Research Associate- I === Research Associate-I q9LzwSSI
Research Associate- II === Research Associate-II q9LzwSSI
Research Associate- III === Research Associate-III q9LzwSSI
Research Associateship === Research Associatehip q9LzwSSI
Research Establishment Officer (Grade I) === Research Establishment Officer Grade-I q9LzwSSI
Research Establishment Officer (Grade II) === Research Establishment Officer Grade-II q9LzwSSI
Research Fellows === Research Fellow q9LzwSSI
Research fellow 2 === Research Fellow 2 q9LzwSSI
Research Fellowship Award === Research Fellowhip Award q9LzwSSI
Research Interns === Research Intern q9LzwSSI
Research Intern cum Drone Operator === Research Intern-cum-Drone Operator q9LzwSSI
Research Internship === Research Internhip q9LzwSSI
Research Officers === Research Officer q9LzwSSI
Research officer A === Research Officer A q9LzwSSI
Research Scientists === Research Scientist q9LzwSSI
Research Scientist- I === Research Scientist-I q9LzwSSI
Research -Data Officer === Research-Data Officer q9LzwSSI
Researcher cum Writer === Researcher-cum-Writer q9LzwSSI
Resident Engineer cum project Manager === Resident Engineer-cum-project Manager q9LzwSSI
Resident Medical Offlcer === Resident Medical Officer q9LzwSSI
Resource Persons === Resource Person q9LzwSSI
Re-toucher Artist === Retoucher Artist q9LzwSSI
Revenue Officer Grade II === Revenue Officer Grade-II q9LzwSSI
Revenue Sup Inspector === Revenue Sub Inspector q9LzwSSI
RHOs === RHO q9LzwSSI
Rifleman Anmourer === Rifleman Armourer q9LzwSSI
Risk Specialist- Credit === Risk Specialist-Credit q9LzwSSI
Risk Specialist- Enterprise === Risk Specialist-Enterprise q9LzwSSI
Risk Specialist- IND AS === Risk Specialist-IND AS q9LzwSSI
Risk Specialist- Sector === Risk Specialist-Sector q9LzwSSI
River Front Management Specialist === Riverfront Management Specialist q9LzwSSI
RMNCH/FP Counsellors-RMNCH === RMNCH/FP Counsellor-RMNCH q9LzwSSI
RTHC-MO cum Lecturer === RTHC-MO-cum-Lecturer q9LzwSSI
Safai karmchar === Safai Karmachari q9LzwSSI
Safai Karamachari === Safai Karmachari q9LzwSSI
Safaikarmchari === Safai Karmachari q9LzwSSI
Safai Karmchari === Safai Karmachari q9LzwSSI
Safai Karamchari === Safai Karmachari q9LzwSSI
Safai Karmachari cum Sub-Staff === Safai Karmachari-cum-Sub-Staff q9LzwSSI
Safaiwalas === Safaiwala q9LzwSSI
Safaiwala (Multi Tasking Staff) === Safaiwala (Multitasking Staff) q9LzwSSI
Safety and Anti-Pollution Officers === Safety and Anti-Pollution Officer q9LzwSSI
Sahayak Samiksh Adhikari === Sahayak Samiksha Adhikari q9LzwSSI
Sales Assistant Grade II === Sales Assistant Grade-II q9LzwSSI
Sales Persons === Sales Person q9LzwSSI
Salesman Cum MTS === Salesman-cum-MTS q9LzwSSI
Sanitary Attendent === Sanitary Attendant q9LzwSSI
Sanitary Attendant Grade- III === Sanitary Attendant Grade-III q9LzwSSI
Senitary Inspector === Sanitary Inspector q9LzwSSI
Sanitary Inspector Grade II === Sanitary Inspector Grade-II q9LzwSSI
Sanitary-Cum-Health Inspector === Sanitary-cum-Health Inspector q9LzwSSI
Sarangi Accompanists === Sarangi Accompanist q9LzwSSI
scaler === Scaler q9LzwSSI
School Facilitator cum Admin Assistant === School Facilitator-cum-Admin Assistant q9LzwSSI
Science Guides === Science Guide q9LzwSSI
Scientific Assistan === Scientific Assistant q9LzwSSI
Scienctific Assistant === Scientific Assistant q9LzwSSI
Scientific Assistants === Scientific Assistant q9LzwSSI
Scientific Assistant - A === Scientific Assistant-A q9LzwSSI
Scientific Assistant cum Photographer === Scientific Assistant-cum-Photographer q9LzwSSI
Scientific Assistat-I === Scientific Assistant-I q9LzwSSI
Scientific Assistant - I === Scientific Assistant-I q9LzwSSI
Scientific Assistant - II === Scientific Assistant-II q9LzwSSI
Scientific Assistant - IV === Scientific Assistant-IV q9LzwSSI
Scientific Officer (B) === Scientific Officer B q9LzwSSI
Scientific Officer (C) === Scientific Officer C q9LzwSSI
Scientific Officer (D) === Scientific Officer D q9LzwSSI
Scientific Officer -SB === Scientific Officer-SB q9LzwSSI
Scientific Technical Officers-I === Scientific Technical Officer-I q9LzwSSI
Scientists / Engineer-SC === Scientist / Engineer-SC q9LzwSSI
Scientists / Engineer-SD === Scientist / Engineer-SD q9LzwSSI
Scientitst B === Scientist B q9LzwSSI
Scientitst C === Scientist C q9LzwSSI
Scientists F === Scientist F q9LzwSSI
Scientists G === Scientist G q9LzwSSI
Scientist - B === Scientist-B q9LzwSSI
Scientist- B === Scientist-B q9LzwSSI
Scientist - C === Scientist-C q9LzwSSI
Scientist - E-II === Scientist-E-II q9LzwSSI
Scientist - F === Scientist-F q9LzwSSI
Scientist -F === Scientist-F q9LzwSSI
Scientist â€“G === Scientist-G q9LzwSSI
Scientist - II === Scientist-II q9LzwSSI
Scientist - III === Scientist-III q9LzwSSI
Scientist - IV === Scientist-IV q9LzwSSI
Scientist - V === Scientist-V q9LzwSSI
Scientist - VI === Scientist-VI q9LzwSSI
Scientist/Technical Supervisor Grade â€“I === Scientist/Technical Supervisor Grade-I q9LzwSSI
Scouts and Guides Quota Level 1 === Scouts and Guide Quota Level 1 q9LzwSSI
Scouts and Guides Quota Level 2 === Scouts and Guide Quota Level 2 q9LzwSSI
Seamans Employment Office === Seamen's Employment Office q9LzwSSI
Secondary Grade Assistant === Secondary Grade-Assistant q9LzwSSI
Secretaries === Secretary q9LzwSSI
Secretary cum Coordinator === Secretary-cum-Coordinator q9LzwSSI
Section Officers === Section Officer q9LzwSSI
Section Officer Grade I === Section Officer Grade-I q9LzwSSI
Section Officer Grade II === Section Officer Grade-II q9LzwSSI
Security Guards === Security Guard q9LzwSSI
Security Guard Grade II === Security Guard Grade-II q9LzwSSI
Security Guard cum Pump Operator === Security Guard-cum-Pump Operator q9LzwSSI
Security Officers === Security Officer q9LzwSSI
Security Officer- In Charge === Security Officer-In Charge q9LzwSSI
Security cum Fire Guard Grade-II === Security-cum-Fire Guard Grade-II q9LzwSSI
Security Cum Fire Jamadar === Security-cum-Fire Jamadar q9LzwSSI
Security-Cum-Fire Jamadar === Security-cum-Fire Jamadar q9LzwSSI
Security cum Vigilance Officer === Security-cum-Vigilance Officer q9LzwSSI
Seed Coordinators === Seed Coordinator q9LzwSSI
Seed Production Technical Managers === Seed Production Technical Manager q9LzwSSI
Seed System Experts === Seed System Expert q9LzwSSI
Semiskilled Mechanic === Semi Skilled Mechanic q9LzwSSI
senior === Senior q9LzwSSI
Sr. Accountant, HQ === Senior Accountant, HQ q9LzwSSI
Senior Account & Statistical Officer === Senior Accounts & Statistical Officer q9LzwSSI
Senior Account Assistant === Senior Accounts Assistant q9LzwSSI
Senior Account Clerk === Senior Accounts Clerk q9LzwSSI
senior  Accounts Executive === Senior Accounts Executive q9LzwSSI
Sr. Account Officer === Senior Accounts Officer q9LzwSSI
Senior Account Officer === Senior Accounts Officer q9LzwSSI
Sr Additional Commissioner === Senior Additional Commissioner q9LzwSSI
Senior Administrative Assistant cum Coordinator === Senior Administrative Assistant-cum-Coordinator q9LzwSSI
Sr. Administrative Officer === Senior Administrative Officer q9LzwSSI
Senior Administrative Officer Grade I === Senior Administrative Officer Grade-I q9LzwSSI
Senior Advisors === Senior Advisor q9LzwSSI
Senior Apprenticeship Supervisor === Senior Apprenticehip Supervisor q9LzwSSI
Sr. Assistant Director === Senior Assistant Director q9LzwSSI
Sr. Assistant. Engineer === Senior Assistant Engineer q9LzwSSI
Senior Bridge Engineer cum Team Leader === Senior Bridge Engineer-cum-Team Leader q9LzwSSI
Senior Cardio Vascular Thoracic Surgeon === Senior Cardiovascular Thoracic Surgeon q9LzwSSI
Senior Clerk cum Typist === Senior Clerk-cum-Typist q9LzwSSI
Senior Commercial cum Ticket Clerk === Senior Commercial-cum-Ticket Clerk q9LzwSSI
Senior Conusltant === Senior Consultant q9LzwSSI
Sr. Consultant === Senior Consultant q9LzwSSI
Senior Consultants === Senior Consultant q9LzwSSI
Sr. Consultant/Disaster Management (DM) === Senior Consultant/Disaster Management (DM) q9LzwSSI
Senior Deckhand-Cum-Cook === Senior Deckhand-cum-Cook q9LzwSSI
Senior Deckhand cum Cook === Senior Deckhand-cum-Cook q9LzwSSI
Senior Demonstrators === Senior Demonstrator q9LzwSSI
Sr. Dy. General Manager === Senior Deputy General Manager q9LzwSSI
Sr. Dy. General Manager/ Architect === Senior Deputy General Manager/ Architect q9LzwSSI
Senior Deputy General Manager OR Deputy General Manager === Senior Deputy General Manager/Deputy General Manager q9LzwSSI
Senior Design Officer Grade -I === Senior Design Officer Grade-I q9LzwSSI
Senior DOTS plus TB - Supervisor === Senior DOTS plus TB-Supervisor q9LzwSSI
Senior Engineer Specialist (Grade-II) === Senior Engineer Specialist Grade-II q9LzwSSI
Sr Executive === Senior Executive q9LzwSSI
Senior Execuitve === Senior Executive q9LzwSSI
Sr. Executive === Senior Executive q9LzwSSI
Sr. Executive/ Executive === Senior Executive/ Executive q9LzwSSI
Sr. Executive/ Operations === Senior Executive/ Operations q9LzwSSI
Senior Faculty Grade I === Senior Faculty Grade-I q9LzwSSI
Senior Faculty Grade.I === Senior Faculty Grade-I q9LzwSSI
Sr. Faculty Gr. I === Senior Faculty Grade-I q9LzwSSI
Senior Faculty GradeII === Senior Faculty Grade-II q9LzwSSI
Sr. Faculty Gr. II === Senior Faculty Grade-II q9LzwSSI
Senior Faculty Grade.II === Senior Faculty Grade-II q9LzwSSI
Senior Fellowship === Senior Fellowhip q9LzwSSI
Senior Highway Engineer cum Team Leader === Senior Highway Engineer-cum-Team Leader q9LzwSSI
Sr. Hindi Translator === Senior Hindi Translator q9LzwSSI
Senior Horticulture Officers === Senior Horticulture Officer q9LzwSSI
Senior House Physician cum Registrar === Senior House Physician-cum-Registrar q9LzwSSI
Senior Internship and Placement Manager === Senior Internhip and Placement Manager q9LzwSSI
Senior Internship and Placement Officer === Senior Internhip and Placement Officer q9LzwSSI
Sr. Laboratory Assistant === Senior Laboratory Assistant q9LzwSSI
Senior Lecturers === Senior Lecturer q9LzwSSI
Senior Lecturer cum Epidemiologist === Senior Lecturer-cum-Epidemiologist q9LzwSSI
Senior Librarians === Senior Librarian q9LzwSSI
Srenior Manager === Senior Manager q9LzwSSI
Sr. Manager === Senior Manager q9LzwSSI
Senior Managers === Senior Manager q9LzwSSI
Sr. Manager (Finance)/AAO === Senior Manager (Finance)/AAO q9LzwSSI
Sr. Manager Corporate Communications === Senior Manager Corporate Communications q9LzwSSI
Senior Mechanic/Sr. Laboratory Assistant === Senior Mechanic/Senior Laboratory Assistant q9LzwSSI
Senior  Medical Officer === Senior Medical Officer q9LzwSSI
Sr. Medical Officer === Senior Medical Officer q9LzwSSI
Sr. Officer (F & A) === Senior Officer (F & A) q9LzwSSI
Senior Operative Trainee- Melts === Senior Operative Trainee-Melts q9LzwSSI
Senor Personnel Officer === Senior Personnel Officer q9LzwSSI
Senior Phlebotomist Grade -II === Senior Phlebotomist Grade-II q9LzwSSI
Senior Principal Private Secretaries === Senior Principal Private Secretary q9LzwSSI
Sr. Principal Private Secretary === Senior Principal Private Secretary q9LzwSSI
Senior Principle Scientist === Senior Principal Scientist q9LzwSSI
Sr. Private Secretary === Senior Private Secretary q9LzwSSI
Senior Priate Secretary === Senior Private Secretary q9LzwSSI
Sr. Procurement & Stores Officer === Senior Procurement & Stores Officer q9LzwSSI
Senior Procurement Cum Store Officer === Senior Procurement-cum-Store Officer q9LzwSSI
Senior Procurement cum Stores Officer === Senior Procurement-cum-Stores Officer q9LzwSSI
Senior Procurement- cum-Stores Officer === Senior Procurement-cum-Stores Officer q9LzwSSI
Sr. Procurement cum Stores Officer === Senior Procurement-cum-Stores Officer q9LzwSSI
Senior Professional Assistant (Hydro-Meterological) === Senior Professional Assistant (Hydro-Meteorological) q9LzwSSI
Senior Project Assistants === Senior Project Assistant q9LzwSSI
Senor Project Associate === Senior Project Associate q9LzwSSI
Senior Project Associate cum Audio & Video Editor === Senior Project Associate-cum-Audio & Video Editor q9LzwSSI
Senior Project Associate cum Graphic Designer === Senior Project Associate-cum-Graphic Designer q9LzwSSI
Senior Project Associate cum Media Outreach Coordinator === Senior Project Associate-cum-Media Outreach Coordinator q9LzwSSI
Senior Project Associate cum Project Associate === Senior Project Associate-cum-Project Associate q9LzwSSI
Senior Project Associate cum Reporter === Senior Project Associate-cum-Reporter q9LzwSSI
Sr. Projeect Engineers (Civil) === Senior Project Engineers (Civil) q9LzwSSI
senior Project Scientist === Senior Project Scientist q9LzwSSI
Senior Proof Reader === Senior Proofreader q9LzwSSI
senior public prosecutor === Senior Public Prosecutor q9LzwSSI
Senior Radiotherpary Technician === Senior Radiotherapy Technician q9LzwSSI
senior Reporter === Senior Reporter q9LzwSSI
Senior Research Asssociate === Senior Research Associate q9LzwSSI
Sr Research Associate === Senior Research Associate q9LzwSSI
Senor Research fellow === Senior Research fellow q9LzwSSI
Senior Research Fcllow === Senior Research Fellow q9LzwSSI
Senior Reseach Fellow === Senior Research Fellow q9LzwSSI
SRF === Senior Research Fellow q9LzwSSI
Senior Research Fellows === Senior Research Fellow q9LzwSSI
Sr. Research Fellow === Senior Research Fellow q9LzwSSI
Senior Research Fellow (SRF) === Senior Research Fellow q9LzwSSI
Senior Research Fellowship === Senior Research Fellowhip q9LzwSSI
Sr Research Officer === Senior Research Officer q9LzwSSI
Sr. Research Officer === Senior Research Officer q9LzwSSI
Senior Research Scientists === Senior Research Scientist q9LzwSSI
Senior Resdient === Senior Resident q9LzwSSI
Senior Resiodent === Senior Resident q9LzwSSI
Senior Residents === Senior Resident q9LzwSSI
Senior Resident Doctors === Senior Resident Doctor q9LzwSSI
Sr. Sanitation Officer === Senior Sanitation Officer q9LzwSSI
Senior Senitation Officer === Senior Sanitation Officer q9LzwSSI
Senior Scientific Assistants === Senior Scientific Assistant q9LzwSSI
Senior Sceintific Assistant === Senior Scientific Assistant q9LzwSSI
Senior  Scientific  Officer === Senior Scientific Officer q9LzwSSI
Sr. Scientist & Head === Senior Scientist & Head q9LzwSSI
Senior Scientists-cum-Head === Senior Scientist-cum-Head q9LzwSSI
Senior Scientist cum Head === Senior Scientist-cum-Head q9LzwSSI
Senior Secondary Recruits === Senior Secondary Recruit q9LzwSSI
Senior Seed Experts === Senior Seed Expert q9LzwSSI
Sr. Site Supervisor === Senior Site Supervisor q9LzwSSI
Sr. Stenographer === Senior Stenographer q9LzwSSI
Senior Supervising Prodecer === Senior Supervising Producer q9LzwSSI
Sr. Technical Assistant === Senior Technical Assistant q9LzwSSI
Senior Technical Assistant (GCS, Group B (NG) Non- Ministerial) === Senior Technical Assistant (GCS, Group B (NG) Non-Ministerial) q9LzwSSI
SeniorTechnical Instructor === Senior Technical Instructor q9LzwSSI
Sr. Technical Officer === Senior Technical Officer q9LzwSSI
Sr. Technical Officer-1 === Senior Technical Officer-1 q9LzwSSI
Sr. Technical Officer - 2 === Senior Technical Officer-2 q9LzwSSI
Sr. Traffic Engineer === Senior Traffic Engineer q9LzwSSI
Sr. Works Engineer === Senior Works Engineer q9LzwSSI
Short Service Commission Officers === Short Service Commission Officer q9LzwSSI
Short-Hand Reporter === Shorthand Reporter q9LzwSSI
Showroom Manager Grade III === Showroom Manager Grade-III q9LzwSSI
SIDBI Development Executives === SIDBI Development Executive q9LzwSSI
Signal Maintainer Grade III === Signal Maintainer Grade-III q9LzwSSI
Signaler cum RTO === Signaler-cum-RTO q9LzwSSI
Skilled Artisans === Skilled Artisan q9LzwSSI
Skilled Assistant Grade II === Skilled Assistant Grade-II q9LzwSSI
Skilled Lab Assistant - II === Skilled Lab Assistant-II q9LzwSSI
Skilled Supporting Staff Grade I === Skilled Supporting Staff Grade-I q9LzwSSI
Skilled Work Assistant â€“ II === Skilled Work Assistant-II q9LzwSSI
Slipway Worker Gr.ll === Slipway Worker Grade-II q9LzwSSI
Social Media Cum Graphic Design Coordinator === Social Media-cum-Graphic Design Coordinator q9LzwSSI
Social Media- Multi-Task Worker === Social Media-Multi-Task Worker q9LzwSSI
Social WorkerSocial Worker === Social Worker q9LzwSSI
Social Worker Cum Data Entry Operator === Social Worker-cum-Data Entry Operator q9LzwSSI
Social Worker cum Early Childhood Educator === Social Worker-cum-Early Childhood Educator q9LzwSSI
Software Programme === Software Programmer q9LzwSSI
Software programmer cum IT Support Executive === Software programmer-cum-IT Support Executive q9LzwSSI
Sofware Tester cum Developer === Software Tester-cum-Developer q9LzwSSI
Solider Technical === Soldier Technical q9LzwSSI
Sound Recordlist === Sound Recordist q9LzwSSI
Speakers === Speaker q9LzwSSI
Special Education Teachers === Special Education Teacher q9LzwSSI
Special Educators === Special Educator q9LzwSSI
Special Educator Grade I === Special Educator Grade-I q9LzwSSI
Special Educator Grade II === Special Educator Grade-II q9LzwSSI
Special Educator cum Orientation and Mobility Instructor === Special Educator-cum-Orientation and Mobility Instructor q9LzwSSI
Special Educators â€“ MR/HI/VI === Special Educators-MR/HI/VI q9LzwSSI
Special Educator/Orientation & Mobility lnstructor === Special Educator/Orientation & Mobility instructor q9LzwSSI
SPECIAL PROJECT MONITOR === Special Project Monitor q9LzwSSI
Specialists === Specialist q9LzwSSI
Specialist Doctors === Specialist Doctor q9LzwSSI
Specialist Grade I === Specialist Grade-I q9LzwSSI
Specialist Gr-II === Specialist Grade-II q9LzwSSI
Specialist Grade â€“ II === Specialist Grade-II q9LzwSSI
Specialist Grade- II === Specialist Grade-II q9LzwSSI
Specialist Grade II === Specialist Grade-II q9LzwSSI
Specialist Gr-II Senior Scale === Specialist Grade-II Senior Scale q9LzwSSI
Specialist Grade III === Specialist Grade-III q9LzwSSI
Specialist Grade III Assistant Professor === Specialist Grade-III Assistant Professor q9LzwSSI
Specialist Grade III Oto-Rhino-Laryngology === Specialist Grade-III Oto-Rhino-Laryngology q9LzwSSI
Specialist Gyneac Oncology === Specialist Gynae Oncology q9LzwSSI
Specialist Medical Officers === Specialist Medical Officer q9LzwSSI
Specialist Medical Officers (Deputy Commandant) === Specialist Medical Officer (Deputy Commandant) q9LzwSSI
Specialist Officers === Specialist Officer q9LzwSSI
Specialist Officer Forex Acquisition  Relationship Manager === Specialist Officer Forex Acquisition Relationship Manager q9LzwSSI
Speech Therapists === Speech Therapist q9LzwSSI
Sport Coache === Sport Coach q9LzwSSI
Sport Persons === Sport Person q9LzwSSI
Sports Associates === Sports Associate q9LzwSSI
Sports Coaches === Sports Coach q9LzwSSI
Sports Officer Gr-I === Sports Officer Grade-I q9LzwSSI
Sports Persons === Sports Person q9LzwSSI
Staff Car Drive === Staff Car Driver q9LzwSSI
Staff Car Drivers === Staff Car Driver q9LzwSSI
Staff Car Driver (Grade-I) === Staff Car Driver Grade-I q9LzwSSI
Staff Car Driver (Grade-II) === Staff Car Driver Grade-II q9LzwSSI
Staff Nurses === Staff Nurse q9LzwSSI
Staff Nurse Gr-II === Staff Nurse Grade-II q9LzwSSI
Staff Nurse Grade II === Staff Nurse Grade-II q9LzwSSI
State Account and Finance Manager Consultant === State Accounts and Finance Manager Consultant q9LzwSSI
State Account Assistant === State Accounts Assistant q9LzwSSI
State Coordinators === State Coordinator q9LzwSSI
State Resource Coordinators === State Resource Coordinator q9LzwSSI
State Resource Persons === State Resource Person q9LzwSSI
Station Controller Cum Train Operator === Station Controller-cum-Train Operator q9LzwSSI
Statistical Filed surveyor === Statistical Field surveyor q9LzwSSI
Statistical Investigator Grade- I === Statistical Investigator Grade-I q9LzwSSI
Statistician cum Lecturer === Statistician-cum-Lecturer q9LzwSSI
Statistician Cum Medical Record Librarian === Statistician-cum-Medical Record Librarian q9LzwSSI
Statistician-cum- Programmer === Statistician-cum-Programmer q9LzwSSI
Statistician-cum -Programmer === Statistician-cum-Programmer q9LzwSSI
Steno Grade D === Steno Grade-D q9LzwSSI
Steno Grade II === Steno Grade-II q9LzwSSI
Steno Grade-Il === Steno Grade-II q9LzwSSI
Steno Grade - III === Steno Grade-III q9LzwSSI
Steno Typists === Steno Typist q9LzwSSI
Stenographerer === Stenographer q9LzwSSI
Stenographers === Stenographer q9LzwSSI
Stenographer Grade C === Stenographer Grade-C q9LzwSSI
Stenographer Grade "C" === Stenographer Grade-C q9LzwSSI
Stenographer Grade "D" === Stenographer Grade-D q9LzwSSI
Stenographer Grade D === Stenographer Grade-D q9LzwSSI
Stenographer (Grade-I) === Stenographer Grade-I q9LzwSSI
Stenographer Gr. I === Stenographer Grade-I q9LzwSSI
Stenographer Grade I === Stenographer Grade-I q9LzwSSI
Stenographer (Grade I) === Stenographer Grade-I q9LzwSSI
Stenographer Grade - I === Stenographer Grade-I q9LzwSSI
Stenographer Grade-l === Stenographer Grade-I q9LzwSSI
Stenographer Grade-lI === Stenographer Grade-II q9LzwSSI
Stenographer Grade â€“ II === Stenographer Grade-II q9LzwSSI
Stenographer Grade -II === Stenographer Grade-II q9LzwSSI
Stenographer Grade-ll === Stenographer Grade-II q9LzwSSI
Stenographer Gr.II === Stenographer Grade-II q9LzwSSI
Stenographer (Grade-II) === Stenographer Grade-II q9LzwSSI
Stenographer Gr.ll === Stenographer Grade-II q9LzwSSI
Stenographer Grade II === Stenographer Grade-II q9LzwSSI
Stenographer Grade - II === Stenographer Grade-II q9LzwSSI
Stenographer Grade-Il/PA === Stenographer Grade-II/PA q9LzwSSI
Stenographer Gr.llI === Stenographer Grade-III q9LzwSSI
Stenographer Gr. III === Stenographer Grade-III q9LzwSSI
Stenographer Grade-lII === Stenographer Grade-III q9LzwSSI
Stenographer Grade III === Stenographer Grade-III q9LzwSSI
Stenographer Grade - III === Stenographer Grade-III q9LzwSSI
Stenographer Gr.III === Stenographer Grade-III q9LzwSSI
Stenographer (Grade -III) === Stenographer Grade-III q9LzwSSI
Stenographer Grade-Ill === Stenographer Grade-IIl q9LzwSSI
Stenographer Grade IV === Stenographer Grade-IV q9LzwSSI
Stenographer Cum Clerk === Stenographer-cum-Clerk q9LzwSSI
Stenographer cum Computer Operator === Stenographer-cum-Computer Operator q9LzwSSI
Stenographer Cum Typist === Stenographer-cum-Typist q9LzwSSI
Sterilisation Technician Grade II === Sterilisation Technician Grade-II q9LzwSSI
Steward Cum Store Incharge === Steward-cum-Store Incharge q9LzwSSI
Stipendiary Clinical Associates === Stipendiary Clinical Associate q9LzwSSI
Stipendary Junior Resident === Stipendiary Junior Resident q9LzwSSI
Stipendary Senior Resident === Stipendiary Senior Resident q9LzwSSI
Stipendiary Trainees === Stipendiary Trainee q9LzwSSI
Store Assistant Grade II === Store Assistant Grade-II q9LzwSSI
Store Attendent === Store Attendant q9LzwSSI
Store Attendant Grade II === Store Attendant Grade-II q9LzwSSI
Store Keeper Grade I === Store Keeper Grade-I q9LzwSSI
Store Keeper Grade II === Storekeeper Grade-II q9LzwSSI
Store Keeper cum Accountant === Store Keeper-cum-Accountant q9LzwSSI
Store Keeper cum Clerk === Store Keeper-cum-Clerk q9LzwSSI
Store Keeper cum Pro MIS Operator === Store Keeper-cum-Pro MIS Operator q9LzwSSI
Store keeper cum Purchase Assistant === Store keeper-cum-Purchase Assistant q9LzwSSI
Store-Keeper === Storekeeper q9LzwSSI
Storekeeper cum Purchase Assistant === Storekeeper-cum-Purchase Assistant q9LzwSSI
Storekeeperâ€“III === Storekeeper-III q9LzwSSI
Stores Officers === Stores Officer q9LzwSSI
Student Coordinator cum Assistant Finance === Student Coordinator-cum-Assistant Finance q9LzwSSI
Student Internship === Student Internhip q9LzwSSI
Student Internship Associate === Student Internhip Associate q9LzwSSI
Student Internship Fellow === Student Internhip Fellow q9LzwSSI
Students Mobilizer cum Counsellor === Students Mobilizer-cum-Counsellor q9LzwSSI
Sub Division Enginner === Sub Division Engineer q9LzwSSI
Sub Divisional Agricultural Officer === Sub Divisional Agriculture Officer q9LzwSSI
Sub-Inpector === Sub-Inspector q9LzwSSI
Sub-Inpsector === Sub-Inspector q9LzwSSI
Subject Experts === Subject Expert q9LzwSSI
Subject Matter Specialis === Subject Matter Specialist q9LzwSSI
Summer Internship === Summer Internhip q9LzwSSI
Super Specialists === Super Specialist q9LzwSSI
Super Specialists Doctors === Super Specialist Doctor q9LzwSSI
Super Specialist Medical Officers (Second in Command) === Super Specialist Medical Officer (Second in Command) q9LzwSSI
super speciality specialists === Super Speciality Specialists q9LzwSSI
Superitendent === Superintendent q9LzwSSI
Supdt === Superintendent q9LzwSSI
Supdt(Store) === Superintendent (Store) q9LzwSSI
Supdt (Store) === Superintendent (Store) q9LzwSSI
Superintendent Grade II === Superintendent Grade-II q9LzwSSI
Superintendent cum Probation Officer === Superintendent-cum-Probation Officer q9LzwSSI
Superintending Enginee === Superintending Engineer q9LzwSSI
Superintending  Engineer === Superintending Engineer q9LzwSSI
Suprintending Engineer === Superintending Engineer q9LzwSSI
Supervisior === Supervisor q9LzwSSI
Supervisors === Supervisor q9LzwSSI
Supervisor (Jr. Hindi Translator) === Supervisor (Junior Hindi Translator) q9LzwSSI
Supervisor cum Data Entry operator === Supervisor-cum-Data Entry operator q9LzwSSI
Supervisor- Payroll & Compliance === Supervisor-Payroll & Compliance q9LzwSSI
Servey Executive === Survey Executive q9LzwSSI
Survey Lascars === Survey Lascar q9LzwSSI
Suveyor === Surveyor q9LzwSSI
Surveyor Grade II === Surveyor Grade-II q9LzwSSI
Surveyor cum Assistant Draughtsman === Surveyor-cum-Assistant Draughtsman q9LzwSSI
Surveyor Cum Draftsman === Surveyor-cum-Draftsman q9LzwSSI
Sweeper cum cleaner === Sweeper-cum-cleaner q9LzwSSI
Sweeper cum messenger === Sweeper-cum-messenger q9LzwSSI
Sweeper Cum Porter === Sweeper-cum-Porter q9LzwSSI
Sweeper/SafaiKaramchari === Sweeper/Safai Karamchari q9LzwSSI
Swimming Coach cum Life Guard === Swimming Coach-cum-Lifeguard q9LzwSSI
Swimming Instructor Cum Technical Staff === Swimming Instructor-cum-Technical Staff q9LzwSSI
Swimming Life Guard === Swimming Lifeguard q9LzwSSI
Swimming pool caretaker cum Life Guard === Swimming pool caretaker-cum-Lifeguard q9LzwSSI
Syrang Of Lascars === Syrang Of Lascar q9LzwSSI
Systern Administrator === System Administrator q9LzwSSI
System Administrator cum Logistic Manager === System Administrator-cum-Logistic Manager q9LzwSSI
System Analyst cum Computer Programmer === System Analyst-cum-Computer Programmer q9LzwSSI
System Analyst-cum- Programmer === System Analyst-cum-Programmer q9LzwSSI
System Analyst cum System Administrator === System Analyst-cum-System Administrator q9LzwSSI
System Manager cum Analyst === System Manager-cum-Analyst q9LzwSSI
System Trainees === System Trainee q9LzwSSI
System cum Surveillance Engineer === System-cum-Surveillance Engineer q9LzwSSI
Systems cum Surveillance Engineer === Systems-cum-Surveillance Engineer q9LzwSSI
Tabla Accompanists === Tabla Accompanist q9LzwSSI
Tabulat or cum Operator === Tabulator-cum-Operator q9LzwSSI
Tailor Cum Attendant === Tailor-cum-Attendant q9LzwSSI
Tanpura Accompanists === Tanpura Accompanist q9LzwSSI
TB Health visitor cum Data Manager === TB Health visitor-cum-Data Manager q9LzwSSI
TBHIV Coordinator === TB HIV Coordinator q9LzwSSI
TB Watchers === TB Watcher q9LzwSSI
Teachers === Teacher q9LzwSSI
Teacher Cum Coordinator === Teacher-cum-Coordinator q9LzwSSI
Teacher-Cum-Librarian === Teacher-cum-Librarian q9LzwSSI
teaching Assistants === Teaching Assistants q9LzwSSI
Teaching  Associates === Teaching Associates q9LzwSSI
Teaching Associates === Teaching Associate q9LzwSSI
Teaching Positions === Teaching Position q9LzwSSI
Teaching Cum Research === Teaching-cum-Research q9LzwSSI
Teaching cum Research Associate === Teaching-cum-Research Associate q9LzwSSI
Teaching cum Research Fellow === Teaching-cum-Research Fellow q9LzwSSI
Teaching cum Research Officer === Teaching-cum-Research Officer q9LzwSSI
Team Leaders === Team Leader q9LzwSSI
Team Leaders / Architects === Team Leader / Architect q9LzwSSI
Tech Support Executives === Tech Support Executive q9LzwSSI
Technical Apprentices === Technical Apprentice q9LzwSSI
Technical Architech === Technical Architect q9LzwSSI
Techincal Assistant === Technical Assistant q9LzwSSI
Technical Assistants === Technical Assistant q9LzwSSI
Technical Assistant Grade I === Technical Assistant Grade-I q9LzwSSI
Technical Assistant Grade II === Technical Assistant Grade-II q9LzwSSI
Technical Asst. Gr.III (Tool Room / Testing / Processing / Design (CAD- CAM-CAE)) === Technical Assistant Grade-III (Tool Room / Testing / Processing / Design (CAD-CAM-CAE)) q9LzwSSI
Technical Assistant cum Programmer === Technical Assistant-cum-Programmer q9LzwSSI
Technical Consultants === Technical Consultant q9LzwSSI
Technical Coordinators === Technical Coordinator q9LzwSSI
Technical Lead â€“ PHP === Technical Lead-PHP q9LzwSSI
Techincal Officer === Technical Officer q9LzwSSI
Technical Officer Gr-I === Technical Officer Grade-I q9LzwSSI
Technical Officer Gr-II === Technical Officer Grade-II q9LzwSSI
Technical Officerâ€“C === Technical Officer-C q9LzwSSI
Technical Officer - D === Technical Officer-D q9LzwSSI
Technical Officer- I === Technical Officer-I q9LzwSSI
Technical Officer - I === Technical Officer-I q9LzwSSI
Technical Officer- II === Technical Officer-II q9LzwSSI
Technical Supervisor Bood Bank === Technical Supervisor Blood Bank q9LzwSSI
Technicianhttps://cpri.res.in/ === Technician q9LzwSSI
Technicians === Technician q9LzwSSI
Technician (Diploma) Apprentices === Technician (Diploma) Apprentice q9LzwSSI
Technician (Diploma) Apprenticeship Trainee === Technician (Diploma) Apprenticehip Trainee q9LzwSSI
Technician (Diploma) Apprenticeship Trainees === Technician (Diploma) Apprenticehip Trainee q9LzwSSI
Technician (Radio Therapy) Grade II === Technician (Radio Therapy) Grade-II q9LzwSSI
Technician (Telephone) Grade IV === Technician (Telephone) Grade-IV q9LzwSSI
Technician Apprentices === Technician Apprentice q9LzwSSI
Technician Apprentices Trainee === Technician Apprentice Trainee q9LzwSSI
Technician Apprenticeship Trainees === Technician Apprenticehip Trainee q9LzwSSI
Technician Diploma Apprentices === Technician Diploma Apprentice q9LzwSSI
Technician Grade I === Technician Grade-I q9LzwSSI
Technician Grade II === Technician Grade-II q9LzwSSI
Technician Grade III === Technician Grade-III q9LzwSSI
Technician GR.III === Technician Grade-III q9LzwSSI
Technician Tumer === Technician Tumor q9LzwSSI
Technician -A === Technician-A q9LzwSSI
Technician -B === Technician-B q9LzwSSI
Technician -C === Technician-C q9LzwSSI
Technician - C === Technician-C q9LzwSSI
Technician Cum Sub Station Operator === Technician-cum-Sub Station Operator q9LzwSSI
Technician - D === Technician-D q9LzwSSI
Technician - I === Technician-I q9LzwSSI
Technician - II === Technician-II q9LzwSSI
Techno Legal Consultants === Techno Legal Consultant q9LzwSSI
Technology Consultants === Technology Consultant q9LzwSSI
Telecouncellor === Telecounselor q9LzwSSI
Telecom Maintainer Grade III === Telecom Maintainer Grade-III q9LzwSSI
Telephone Operator cum junior Assistant === Telephone Operator-cum-Junior Assistant q9LzwSSI
Tester-cum- Gauger === Tester-cum-Gauger q9LzwSSI
Textile Deginer === Textile Designer q9LzwSSI
Theatre Artists === Theatre Artist q9LzwSSI
Timber Supervisors === Timber Supervisor q9LzwSSI
Time Keeper Grade II === Time Keeper Grade-II q9LzwSSI
Tin Simith === Tinsmith q9LzwSSI
Town Planning Surveyor Grade II === Town Planning Surveyor Grade-II q9LzwSSI
TPA Executive cum Team Leader === TPA Executive-cum-Team Leader q9LzwSSI
Track Maintainer Grade IV === Track Maintainer Grade-IV q9LzwSSI
Tractor Mechanic-Cum-Driver === Tractor Mechanic-cum-Driver q9LzwSSI
Trade and Technician Apprentices === Trade and Technician Apprentice q9LzwSSI
Trade Apprentices === Trade Apprentice q9LzwSSI
Trade Apprentice (Data Entry Operator-Fresher Apprentices) === Trade Apprentice (Data Entry Operator-Fresher Apprentice) q9LzwSSI
Trade Apprentice- Data Entry Operator (Skill Certificate Holders) === Trade Apprentice-Data Entry Operator (Skill Certificate Holders) q9LzwSSI
Trade Instructor Grade II === Trade Instructor Grade-II q9LzwSSI
Tradesmen Mate === Tradesman Mate q9LzwSSI
Tradesman- A === Tradesman-A q9LzwSSI
Traffic Inspector Cum Field Supervisor === Traffic Inspector-cum-Field Supervisor q9LzwSSI
Trained Graduate Teachers === Trained Graduate Teacher q9LzwSSI
Trained Graduate Teachers (TGT) === Trained Graduate Teacher (TGT) q9LzwSSI
Trainee Engineer -I === Trainee Engineer-I q9LzwSSI
Trainee Publication Officers === Trainee Publication Officer q9LzwSSI
Traineeship === Traineehip q9LzwSSI
Training  Assistant === Training Assistant q9LzwSSI
raining Assistant === Training Assistant q9LzwSSI
Training cum Research Assistant === Training-cum-Research Assistant q9LzwSSI
Training, Internship and Placement Officer === Training, Internhip and Placement Officer q9LzwSSI
Training Internship and Placement Of === Training, Internship and Placement Officer q9LzwSSI
Transit House Keeper === Transit Housekeeper q9LzwSSI
Transport Supersior === Transport Supervisor q9LzwSSI
Treasury Officer Junior Grade II === Treasury Officer Junior Grade-II q9LzwSSI
Treatment Organizer Gr-II === Treatment Organizer Grade-II q9LzwSSI
Tribunal Master/ Stenographer Grade- â€˜Iâ€™ === Tribunal Master/ Stenographer Grade-I q9LzwSSI
Tuberculosis Health Visitors === Tuberculosis Health Visitor q9LzwSSI
Tuberculosis Health Vistor === Tuberculosis Health Visitor q9LzwSSI
Tube-well Operator === Tubewell Operator q9LzwSSI
Tutors === Tutor q9LzwSSI
Tutor Specialists === Tutor Specialist q9LzwSSI
Tutor cum Research Associate === Tutor-cum-Research Associate q9LzwSSI
Typist Clerk Grade II === Typist Clerk Grade-II q9LzwSSI
Typist Grade II === Typist Grade-II q9LzwSSI
Typist Cum Clerk === Typist-cum-Clerk q9LzwSSI
Typist cum Computer Operator === Typist-cum-Computer Operator q9LzwSSI
Typist cum Record Keeper === Typist-cum-Record Keeper q9LzwSSI
Typist Cum Scribe Assistant === Typist-cum-Scribe Assistant q9LzwSSI
University Care Taker === University Caretaker q9LzwSSI
Upholester === Upholsterer q9LzwSSI
Upper Divison Clerk === Upper Division Clerk q9LzwSSI
Upeer Division Clerk === Upper Division Clerk q9LzwSSI
Upper Division Clerks === Upper Division Clerk q9LzwSSI
Urban Expert cum Content Writer === Urban Expert-cum-Content Writer q9LzwSSI
Urban Sector Expert cum Content Writer === Urban Sector Expert-cum-Content Writer q9LzwSSI
Uro-dynamic Technician === Urodynamic Technician q9LzwSSI
UTHC-MO cum Lecturer === UTHC-MO-cum-Lecturer q9LzwSSI
Utility Agent Cum Ramp Driver === Utility Agent-cum-Ramp Driver q9LzwSSI
Vehicle Driver Cum Mechanic === Vehicle Driver-cum-Mechanic q9LzwSSI
Vertical Consultanat === Vertical Consultant q9LzwSSI
Veterinary Extention Officer === Veterinary Extension Officer q9LzwSSI
Vice Principal Cum Professor === Vice Principal-cum-Professor q9LzwSSI
Vice-Principal cum Professor === Vice-Principal-cum-Professor q9LzwSSI
Video Editors === Video Editor q9LzwSSI
Videographer-Cum-Technical Assistant === Videographer-cum-Technical Assistant q9LzwSSI
Violin Accompanists === Violin Accompanist q9LzwSSI
Visiting Doctors === Visiting Doctor q9LzwSSI
Visiting Specialist Doctors === Visiting Specialist Doctor q9LzwSSI
Visual Artiste === Visual Artist q9LzwSSI
Vocational I nstructor === Vocational Instructor q9LzwSSI
Ward Boys === Ward Boy q9LzwSSI
Warden Grade I === Warden Grade-I q9LzwSSI
Warden Grade II === Warden Grade-II q9LzwSSI
Warrant Officer Draftmans === Warrant Officer Draftsman q9LzwSSI
Waste Water Specialist === Wastewater Specialist q9LzwSSI
Watcher Grade II === Watcher Grade-II q9LzwSSI
Watchman Cum Gardener === Watchman-cum-Gardener q9LzwSSI
Water Pump Operator Grade- II === Water Pump Operator Grade-II q9LzwSSI
Web Manager cum lT Expert === Web Manager-cum-lT Expert q9LzwSSI
Web Master === Webmaster q9LzwSSI
Website Developer cum Graphic Designer === Website Developer-cum-Graphic Designer q9LzwSSI
Website cum Data entry Assistant === Website-cum-Data entry Assistant q9LzwSSI
Weigh Bridge Supervisor === Weighbridge Supervisor q9LzwSSI
Welder Cum Fitter === Welder-cum-Fitter q9LzwSSI
Welfare Officer cum Assistant Superintendent Jail === Welfare Officer-cum-Assistant Superintendent Jail q9LzwSSI
Whole-Time Members === Whole-Time Member q9LzwSSI
Wild Life Assistant Grade II === Wildlife Assistant Grade-II q9LzwSSI
Wild life Inspector === Wildlife Inspector q9LzwSSI
Wireless Operators === Wireless Operator q9LzwSSI
Wood work Instructor === Woodwork Instructor q9LzwSSI
Work Experience Teachers === Work Experience Teacher q9LzwSSI
Worker cum Cleaner === Worker-cum-Cleaner q9LzwSSI
Work Shop Attendant === Workshop Attendant q9LzwSSI
Workshop Demonstrator cum Attendant === Workshop Demonstrator-cum-Attendant q9LzwSSI
Workshop Supervisor cum Store Keeper === Workshop Supervisor-cum-Storekeeper q9LzwSSI
Workshop Supervisor cum Storekeeper === Workshop Supervisor-cum-Storekeeper q9LzwSSI
Workshop Supervisor- cum-Store Keeper === Workshop Supervisor-cum-Storekeeper q9LzwSSI
Workshop Supervisor-cum-StoreKepper === Workshop Supervisor-cum-Storekeeper q9LzwSSI
Workshop Supervisor-cum-Store Keeper === Workshop Supervisor-cum-Storekeeper q9LzwSSI
Workshop Supervisor-cum-Store Kepper === Workshop Supervisor-cum-Storekeeper q9LzwSSI
Workshop Technician Grade II === Workshop Technician Grade-II q9LzwSSI
X-Ray Assistant === X-ray Assistant q9LzwSSI
X-Ray Mechanic === X-ray Mechanic q9LzwSSI
X-Ray Operator === X-ray Operator q9LzwSSI
X- Ray Operator === X-ray Operator q9LzwSSI
X- Ray Technician === X-ray Technician q9LzwSSI
X Ray Technician === X-ray Technician q9LzwSSI
X-Ray Technician Grade-II === X-ray Technician Grade-II q9LzwSSI
Yoga Care Instuctor === Yoga Care Instructor q9LzwSSI
Yoga Instructors === Yoga Instructor q9LzwSSI
Yoga Instructor cum trial coordinator === Yoga Instructor-cum-trial coordinator q9LzwSSI
Yoga Internees === Yoga Internee q9LzwSSI
Young Archaeological === Young Archaeologist q9LzwSSI
Young Consultants === Young Consultant q9LzwSSI
Young Professionals === Young Professional q9LzwSSI
Young Professional Graduates === Young Professional Graduate q9LzwSSI
Young Professional Il === Young Professional II q9LzwSSI
Young Professional â€“ I === Young Professional-I q9LzwSSI
Young Professional- I === Young Professional-I q9LzwSSI
Young Profession I === Young Professional-I q9LzwSSI
Young Professional - I === Young Professional-I q9LzwSSI
Young Professional -I === Young Professional-I q9LzwSSI
Young Professionals-I === Young Professional-I q9LzwSSI
Young Professionals-II === Young Professional-II q9LzwSSI
Young Professiona l-ll === Young Professional-II q9LzwSSI
Young Professionalâ€“II === Young Professional-II q9LzwSSI
Young Professional-Il === Young Professional-II q9LzwSSI
Young Professional- II === Young Professional-II q9LzwSSI
Young Professional -II === Young Professional-II q9LzwSSI
Young Professional - II === Young Professional-II q9LzwSSI
Young Professional-lI === Young Professional-II q9LzwSSI
Young Professional- Il === Young Professional-II q9LzwSSI
Youth Mental health Counselor === Youth Mental Health Counselor q9LzwSSI
